SEQ,STATE_DT,STATE_TIME,DECIDE_CNT,CLEAR_CNT,EXAM_CNT,DEATH_CNT,CARE_CNT,RESULT_NEG_CNT,ACC_EXAM_CNT,ACC_EXAM_COMP_CNT,ACC_DEF_RATE,CREATE_DT,UPDATE_DT
692,2021-11-09,00:00,383407,350658,1520380,2998,29751,14309086,16212873,14692493,2.6095435267,2021-11-09 09:24:09.116,null
691,2021-11-08,00:00,381692,347797,1518345,2980,30915,14260796,16160833,14642488,2.6067427885,2021-11-08 09:28:41.663,2021-11-09 09:30:27.242
690,2021-11-07,00:00,379934,346801,1497751,2967,30166,14253188,16130873,14633122,2.5963974058,2021-11-07 09:29:07.692,2021-11-08 09:08:05.416
689,2021-11-06,00:00,377710,345566,1472186,2956,29188,14249291,16099187,14627001,2.5822791698,2021-11-06 09:37:28.182,2021-11-08 09:07:48.135
688,2021-11-05,00:00,375463,343237,1475027,2936,29290,14201178,16051668,14576641,2.5757854638,2021-11-05 09:27:51.19,2021-11-07 09:44:48.33
687,2021-11-04,00:00,373120,341888,1464968,2916,28316,14163144,16001232,14536264,2.5668218463,2021-11-04 09:27:32.684,null
686,2021-11-03,00:00,370638,340471,1451112,2892,27275,14131777,15953527,14502415,2.5556984819,2021-11-03 09:28:24.308,2021-11-04 09:27:53.323
685,2021-11-02,00:00,367970,338947,1443843,2874,26149,14093372,15905185,14461342,2.5445079716,2021-11-02 09:30:05.194,2021-11-04 09:31:12.867
684,2021-11-01,00:00,366382,337353,1424100,2858,26171,14058818,15849300,14425200,2.5398746637,2021-11-01 06:42:25.145,2021-11-04 09:31:23.547
683,2021-10-31,00:00,364697,336548,1386962,2849,25300,14052403,15804062,14417100,2.5296141387,2021-10-31 09:17:32.729,2021-11-04 09:31:44.097
682,2021-10-30,00:00,362636,334581,1366434,2830,25225,14046627,15775697,14409263,2.5166866619,2021-10-30 09:42:07.803,2021-11-04 09:31:55.49
681,2021-10-29,00:00,360532,332995,1358692,2817,24720,14011558,15730782,14372090,2.5085565147,2021-10-29 09:31:17.46,2021-11-04 09:32:05.724
680,2021-10-28,00:00,358411,330853,1389130,2808,24750,13930645,15678186,14289056,2.5082902607,2021-10-28 09:33:44.198,2021-11-01 06:34:15.071
679,2021-10-27,00:00,356300,329658,1387186,2797,23845,13884820,15628306,14241120,2.5019099621,2021-10-27 10:10:24.763,2021-10-30 09:44:12.063
677,2021-10-26,00:00,354355,327592,1366840,2788,23975,13858235,15579430,14212590,2.4932471843,2021-10-26 09:39:33.439,2021-10-26 19:11:36.585
676,2021-10-25,00:00,353083,324448,1368282,2773,25862,13809107,15530472,14162190,2.4931384199,2021-10-25 09:45:03.736,2021-10-30 09:44:54.809
675,2021-10-24,00:00,351893,323393,1354359,2766,25734,13798727,15504979,14150620,2.4867673642,2021-10-24 09:33:19.08,2021-10-30 09:45:50.551
674,2021-10-23,00:00,350472,322536,1339287,2745,25191,13791710,15481469,14142182,2.4782031513,2021-10-23 10:02:54.872,2021-10-28 09:30:49.899
673,2021-10-22,00:00,348964,320317,1327170,2725,25922,13761248,15437382,14110212,2.4731308076,2021-10-22 09:40:09.614,2021-10-28 09:30:42.515
672,2021-10-21,00:00,347526,317755,1334586,2709,27062,13709892,15392004,14057418,2.4721894162,2021-10-21 09:43:46.67,2021-10-28 09:30:26.032
671,2021-10-20,00:00,346085,316607,1325132,2698,26780,13673512,15344729,14019597,2.4685802309,2021-10-20 09:37:29.36,2021-10-28 09:30:16.686
670,2021-10-19,00:00,344514,313432,1323771,2689,28393,13628545,15296830,13973059,2.4655589015,2021-10-19 09:37:01.052,2021-10-28 09:30:04.103
669,2021-10-18,00:00,343441,311781,1320566,2668,28992,13582339,15246346,13925780,2.4662245130,2021-10-18 09:39:38.125,2021-10-28 09:29:55.295
668,2021-10-17,00:00,342391,310344,1312433,2660,29387,13566040,15220864,13908431,2.4617514369,2021-10-17 10:04:43.41,2021-10-28 09:29:46.068
667,2021-10-16,00:00,340971,308187,1293233,2644,30140,13563983,15198187,13904954,2.4521548219,2021-10-16 09:35:29.169,2021-10-28 09:29:35.805
666,2021-10-15,00:00,339354,305851,1309168,2626,30877,13503999,15152521,13843353,2.4513858745,2021-10-15 09:39:06.702,2021-10-28 19:13:07.804
665,2021-10-14,00:00,337671,303719,1296534,2618,31334,13472155,15106360,13809826,2.4451502864,2021-10-14 09:34:17.552,2021-10-28 09:28:39.581
664,2021-10-13,00:00,335732,302066,1285868,2605,31061,13440812,15062412,13776544,2.4369827440,2021-10-13 09:35:45.02,2021-10-28 09:28:28.48
663,2021-10-12,00:00,334149,299260,1276809,2594,32295,13396614,15007572,13730763,2.4335792555,2021-10-12 10:34:11.074,2021-10-28 09:28:16.636
662,2021-10-11,00:00,332803,298022,1255745,2583,32198,13388859,14977407,13721662,2.4253840387,2021-10-11 09:36:36.635,2021-10-28 09:28:03.328
661,2021-10-10,00:00,331506,296708,1261712,2575,32223,13358428,14951646,13689934,2.4215310314,2021-10-10 09:40:09.109,2021-10-28 09:27:46.567
660,2021-10-09,00:00,329912,294929,1247124,2560,32423,13348827,14925863,13678739,2.4118597481,2021-10-09 09:42:58.176,2021-10-28 09:27:35.791
659,2021-10-08,00:00,327959,292091,1232857,2554,33314,13321370,14882186,13649329,2.4027481497,2021-10-08 09:46:59.694,2021-10-28 09:27:22.408
658,2021-10-07,00:00,325788,288822,1239741,2544,34422,13268436,14833965,13594224,2.3965178152,2021-10-07 09:48:27.592,2021-10-28 09:27:02.424
657,2021-10-06,00:00,323363,287040,1219801,2536,33787,13237774,14780938,13561137,2.3844829530,2021-10-06 09:49:43.197,2021-10-28 09:26:50.574
656,2021-10-05,00:00,321336,284197,1228509,2524,34615,13181782,14731627,13503118,2.3797170401,2021-10-05 09:54:11.433,2021-10-28 09:26:38.781
655,2021-10-04,00:00,319762,282669,1216193,2513,34580,13165256,14701211,13485018,2.3712389557,2021-10-04 09:50:15.715,2021-10-28 09:26:15.517
654,2021-10-03,00:00,318092,278847,1202878,2507,36738,13154145,14675115,13472237,2.3610926678,2021-10-03 10:22:27.003,2021-10-28 09:26:02.548
653,2021-10-02,00:00,316007,277092,1179529,2504,36411,13149149,14644685,13465156,2.3468498991,2021-10-02 09:52:30.389,2021-11-01 06:39:30.832
652,2021-10-01,00:00,313760,275576,1169025,2497,35687,13113426,14596211,13427186,2.3367517214,2021-10-01 09:57:42.109,2021-11-01 06:39:17.105
651,2021-09-30,00:00,311276,274205,1149658,2481,34590,13083312,14544246,13394588,2.3238937994,2021-09-30 09:58:40.205,2021-11-01 06:39:07.437
650,2021-09-29,00:00,308715,272724,1137617,2474,33517,13038919,14485251,13347634,2.3128818186,2021-09-29 09:58:03.378,2021-11-01 06:38:56.4
649,2021-09-28,00:00,305834,270928,1135394,2464,32442,12984337,14425565,13290171,2.3012044013,2021-09-28 09:57:34.945,2021-11-01 06:38:31.954
648,2021-09-27,00:00,303546,269132,1120111,2456,31958,12942271,14365928,13245817,2.2916366729,2021-09-27 10:08:41.366,2021-11-01 06:38:21.019
647,2021-09-26,00:00,301165,268140,1096862,2450,30575,12927905,14325932,13229070,2.2765394695,2021-09-26 09:38:04.296,2021-11-01 06:38:11.541
646,2021-09-25,00:00,298397,266411,1056223,2441,29545,12930717,14285337,13229114,2.2556083498,2021-09-25 10:49:15.225,2021-10-27 21:20:33.866
645,2021-09-24,00:00,295127,264490,1030500,2434,28203,12896055,14221682,13191182,2.2373051937,2021-09-24 09:53:29.116,2021-10-28 19:03:18.131
644,2021-09-23,00:00,292698,262840,1034720,2427,27431,12823651,14151069,13116349,2.2315508683,2021-09-23 10:01:14.491,2021-10-28 19:04:10.216
643,2021-09-22,00:00,290983,261810,997996,2419,26754,12823456,14112435,13114439,2.2187986844,2021-09-22 09:35:53.93,2021-09-29 20:01:46.502
642,2021-09-21,00:00,289263,260088,965875,2413,26762,12826146,14081284,13115409,2.2055202395,2021-09-21 09:39:49.437,2021-09-29 20:03:48.311
641,2021-09-20,00:00,287534,259008,953532,2409,26117,12809908,14050974,13097442,2.1953447092,2021-09-20 09:09:41.18,2021-09-29 20:04:59.469
640,2021-09-19,00:00,285930,257447,932234,2403,26080,12802334,14020498,13088264,2.1846289164,2021-09-19 09:31:46.109,2021-09-29 20:06:48.46
639,2021-09-18,00:00,284021,256012,917857,2394,25615,12784737,13986615,13068758,2.1732822659,2021-09-18 09:58:15.323,2021-10-28 19:15:16.036
638,2021-09-17,00:00,281934,254078,921233,2389,25467,12735788,13938955,13017722,2.1657706317,2021-09-17 10:15:01.593,2021-10-28 19:14:59.754
637,2021-09-16,00:00,279926,252028,920101,2386,25512,12690472,13890499,12970398,2.1581912906,2021-09-16 09:51:44.269,2021-10-28 19:14:42.389
636,2021-09-15,00:00,277984,249820,914120,2380,25784,12646983,13839087,12924967,2.1507521063,2021-09-15 09:51:20.667,2021-10-28 19:14:12.98
635,2021-09-14,00:00,275919,247647,914400,2367,25905,12599920,13790239,12875839,2.1429205506,2021-09-14 09:45:02.459,2021-10-28 19:13:59.622
634,2021-09-13,00:00,274411,245491,925739,2360,26560,12535590,13735740,12810001,2.1421622059,2021-09-13 09:40:59.629,2021-10-28 19:20:08.897
633,2021-09-12,00:00,272978,244445,910419,2359,26174,12520776,13704173,12793754,2.1336817950,2021-09-12 09:35:58.19,2021-10-28 19:21:16.406
632,2021-09-11,00:00,271223,242944,895077,2358,25921,12499160,13665460,12770383,2.1238438972,2021-09-11 09:42:37.082,2021-10-28 19:22:56.574
631,2021-09-10,00:00,269359,240716,888674,2348,26295,12457022,13615055,12726381,2.1165404367,2021-09-10 09:40:06.372,2021-10-28 19:22:17.484
630,2021-09-09,00:00,267466,238901,897924,2343,26222,12403479,13568869,12670945,2.1108607132,2021-09-09 09:40:59.551,2021-10-28 19:38:20.905
629,2021-09-08,00:00,265417,237270,898494,2334,25813,12355753,13519664,12621170,2.1029508357,2021-09-08 09:39:50.468,2021-10-28 19:38:49.98
628,2021-09-07,00:00,263370,235209,886983,2330,25831,12318059,13468412,12581429,2.0933234213,2021-09-07 09:39:03.178,2021-10-28 19:39:14.738
627,2021-09-06,00:00,261773,233678,891318,2327,25768,12263652,13416743,12525425,2.0899330761,2021-09-06 09:43:09.889,2021-10-28 19:39:41.096
626,2021-09-05,00:00,260398,232317,874694,2321,25760,12247641,13382733,12508039,2.0818451237,2021-09-05 10:48:36.114,2021-10-28 19:40:09.375
624,2021-09-04,00:00,258908,230390,850535,2315,26203,12240913,13350356,12499821,2.0712936609,2021-09-04 09:41:36.458,2021-10-28 19:40:31.254
623,2021-09-03,00:00,257105,228603,825198,2308,26194,12204374,13286677,12461479,2.0631981163,2021-09-03 09:44:30.979,2021-10-28 19:40:56.019
622,2021-09-02,00:00,255397,226206,819939,2303,26888,12148175,13223511,12403572,2.0590600836,2021-09-02 09:37:25.055,2021-10-28 19:41:37.871
621,2021-09-01,00:00,253437,224305,780979,2292,26840,12117724,13152140,12371161,2.0486112823,2021-09-01 09:37:02.395,2021-10-28 19:42:08.953
590,2021-08-31,00:00,251413,221688,751241,2285,27440,12092057,13094711,12343470,2.0368097463,2021-08-31 00:00:00.0,2021-10-28 19:43:17.524
589,2021-08-30,00:00,250043,220346,766807,2284,27413,12032828,13049678,12282871,2.0357048445,2021-08-30 00:00:00.0,2021-10-28 19:44:30.053
588,2021-08-29,00:00,248558,218713,762594,2279,27566,12004769,13015921,12253327,2.0284939755,2021-08-29 00:00:00.0,2021-10-28 19:50:42.937
587,2021-08-28,00:00,246939,216974,743177,2276,27689,11993370,12983486,12240309,2.0174245601,2021-08-28 00:00:00.0,2021-10-28 19:51:25.711
586,2021-08-27,00:00,245148,214659,718479,2265,28224,11964162,12927789,12209310,2.0078775950,2021-08-27 00:00:00.0,2021-10-28 19:52:24.206
585,2021-08-26,00:00,243311,212860,710599,2257,28194,11912887,12866797,12156198,2.0015386389,2021-08-26 00:00:00.0,2021-10-28 19:53:00.801
584,2021-08-25,00:00,241429,211154,697586,2237,28038,11867593,12806608,12109022,1.9937943791,2021-08-25 00:00:00.0,2021-10-28 19:53:45.286
583,2021-08-24,00:00,239275,209174,688192,2228,27873,11822284,12749751,12061559,1.9837816985,2021-08-24 00:00:00.0,2021-10-28 19:54:27.094
582,2021-08-23,00:00,237768,207584,689243,2222,27962,11767007,12694018,12004775,1.9806118815,2021-08-23 00:00:00.0,2021-10-28 19:55:03.137
581,2021-08-22,00:00,236351,206257,678447,2215,27879,11749534,12664332,11985885,1.9719111271,2021-08-22 00:00:00.0,2021-10-28 19:55:44.759
580,2021-08-21,00:00,234725,204498,667998,2202,28025,11729868,12632591,11964593,1.9618302101,2021-08-21 00:00:00.0,2021-10-28 19:56:39.865
579,2021-08-20,00:00,232938,202754,659590,2197,27987,11674562,12567090,11907500,1.9562292672,2021-08-20 00:00:00.0,2021-10-28 19:57:43.769
578,2021-08-19,00:00,230798,201213,652740,2191,27394,11635157,12518695,11865955,1.9450436142,2021-08-19 00:00:00.0,2021-10-28 19:58:28.318
577,2021-08-18,00:00,228646,199564,634727,2178,26904,11598303,12461676,11826949,1.9332627544,2021-08-18 00:00:00.0,2021-10-28 20:16:22.884
576,2021-08-17,00:00,226843,197211,320680,2173,27459,11857446,12404969,12084289,1.8771729143,2021-08-17 00:00:00.0,2021-10-28 20:17:26.816
575,2021-08-16,00:00,225471,196186,595225,2167,27118,11552073,12372769,11777544,1.9144144144,2021-08-16 00:00:00.0,2021-10-28 20:18:00.209
574,2021-08-15,00:00,223917,195091,585131,2156,26670,11535663,12344711,11759580,1.9041241268,2021-08-15 00:00:00.0,2021-10-28 20:19:10.498
573,2021-08-14,00:00,222101,193766,562705,2148,26187,11524467,12309273,11746568,1.8907735433,2021-08-14 00:00:00.0,2021-10-28 20:19:59.1
572,2021-08-13,00:00,220173,192235,539535,2144,25794,11498251,12257959,11718424,1.8788618674,2021-08-13 00:00:00.0,2021-10-28 20:20:39.71
571,2021-08-12,00:00,218184,190519,510096,2138,25527,11478755,12207035,11696939,1.8653085221,2021-08-12 00:00:00.0,2021-10-28 20:25:41.348
570,2021-08-11,00:00,216197,189491,488067,2135,24571,11451928,12156192,11668125,1.8528855321,2021-08-11 00:00:00.0,2021-10-28 20:26:29.769
569,2021-08-10,00:00,213976,187508,465922,2134,24334,11432181,12112079,11646157,1.8373099383,2021-08-10 00:00:00.0,2021-10-28 20:27:07.024
568,2021-08-09,00:00,212439,186226,467508,2125,24088,11377877,12057824,11590316,1.8329008458,2021-08-09 00:00:00.0,2021-10-28 20:27:36.514
567,2021-08-08,00:00,210948,184987,466279,2121,23840,11350210,12027437,11561158,1.8246269102,2021-08-08 00:00:00.0,2021-10-28 20:31:36.737
566,2021-08-07,00:00,209221,183670,444937,2116,23435,11341765,11995923,11550986,1.811282604,2021-08-07 00:00:00.000,2021-10-07 10:30:51.51
565,2021-08-06,00:00,207398,182457,427050,2113,22828,11317198,11951646,11524596,1.799611891,2021-08-06 00:00:00.000,2021-10-07 10:30:51.51
564,2021-08-05,00:00,205694,180722,415489,2109,22863,11287247,11908430,11492941,1.789742069,2021-08-05 00:00:00.000,2021-10-07 10:30:51.51
563,2021-08-04,00:00,203919,179388,397889,2106,22425,11262432,11864240,11466351,1.77841233,2021-08-04 00:00:00.000,2021-10-07 10:30:51.51
562,2021-08-03,00:00,202194,177790,368300,2104,22300,11249517,11820011,11451711,1.765622622,2021-08-03 00:00:00.000,2021-10-07 10:30:51.51
561,2021-08-02,00:00,200994,176572,387170,2099,22323,11184435,11772599,11385429,1.765361674,2021-08-02 00:00:00.000,2021-10-07 10:30:51.51
560,2021-08-01,00:00,199776,175267,378600,2098,22411,11173404,11751780,11373180,1.756553576,2021-08-01 00:00:00.000,2021-10-07 10:30:51.51
559,2021-07-31,00:00,198334,174341,369201,2095,21898,11161280,11728815,11359614,1.745957213,2021-07-31 00:00:00.000,2021-10-07 10:30:51.51
558,2021-07-30,00:00,196796,172847,357215,2089,21860,11128951,11682962,11325747,1.737598412,2021-07-30 00:00:00.000,2021-10-07 10:30:51.51
557,2021-07-29,00:00,195086,171428,342326,2085,21573,11100088,11637500,11295174,1.727162415,2021-07-29 00:00:00.000,2021-10-07 10:30:51.51
556,2021-07-28,00:00,193413,170230,323954,2083,21100,11068240,11585607,11261653,1.717447696,2021-07-28 00:00:00.000,2021-10-07 10:30:51.51
555,2021-07-27,00:00,191518,169166,309414,2079,20273,11027670,11528602,11219188,1.707057587,2021-07-27 00:00:00.000,2021-10-07 10:30:51.51
554,2021-07-26,00:00,190155,167302,281003,2077,20776,11001181,11472339,11191336,1.699126896,2021-07-26 00:00:00.000,2021-10-07 10:30:51.51
553,2021-07-25,00:00,188837,166039,274761,2073,20725,10989742,11453340,11178579,1.689275533,2021-07-25 00:00:00.000,2021-10-07 10:30:51.51
552,2021-07-24,00:00,187350,165947,274697,2068,19335,10968471,11430518,11155821,1.67939231,2021-07-24 00:00:00.000,2021-10-07 10:30:51.51
551,2021-07-23,00:00,185723,164819,278011,2066,18838,10924565,11388299,11110288,1.671630834,2021-07-23 00:00:00.000,2021-10-07 10:30:51.51
550,2021-07-22,00:00,184094,163780,269496,2063,18251,10890323,11343913,11074417,1.662335814,2021-07-22 00:00:00.000,2021-10-07 10:30:51.51
549,2021-07-21,00:00,182253,162647,252187,2060,17546,10864229,11298669,11046482,1.649873688,2021-07-21 00:00:00.000,2021-10-07 10:30:51.51
548,2021-07-20,00:00,180472,161207,244671,2059,17206,10826839,11251982,11007311,1.639564831,2021-07-20 00:00:00.000,2021-10-07 10:30:51.51
547,2021-07-19,00:00,179194,159920,240689,2058,17216,10782546,11202429,10961740,1.634722225,2021-07-19 00:00:00.000,2021-10-07 10:30:51.51
546,2021-07-18,00:00,177943,159203,265438,2057,16683,10732596,11175977,10910539,1.630927675,2021-07-18 00:00:00.000,2021-10-07 10:30:51.51
545,2021-07-17,00:00,176490,158528,227636,2055,15907,10745097,11149223,10921587,1.615973942,2021-07-17 00:00:00.000,2021-10-07 10:30:51.51
544,2021-07-16,00:00,175041,157533,218192,2051,15457,10715349,11108582,10890390,1.60729781,2021-07-16 00:00:00.000,2021-10-07 10:30:51.51
543,2021-07-15,00:00,173506,156686,204479,2050,14770,10682469,11060454,10855975,1.598253496,2021-07-15 00:00:00.000,2021-10-07 10:30:51.51
542,2021-07-14,00:00,171907,156084,181905,2048,13775,10655045,11008857,10826952,1.587769115,2021-07-14 00:00:00.000,2021-10-07 10:30:51.51
541,2021-07-13,00:00,170294,155065,179130,2046,13183,10614873,10964297,10785167,1.578964888,2021-07-13 00:00:00.000,2021-10-07 10:30:51.51
540,2021-07-12,00:00,169144,154325,174671,2044,12775,10576081,10919896,10745225,1.574131766,2021-07-12 00:00:00.000,2021-10-07 10:30:51.51
539,2021-07-11,00:00,168044,153760,176062,2043,12241,10558170,10902276,10726214,1.566666486,2021-07-11 00:00:00.000,2021-10-07 10:30:51.51
538,2021-07-10,00:00,166720,153153,169719,2038,11529,10545199,10881638,10711919,1.556397131,2021-07-10 00:00:00.000,2021-10-07 10:30:51.51
537,2021-07-09,00:00,165342,152498,160468,2036,10808,10518405,10844215,10683747,1.547603102,2021-07-09 00:00:00.000,2021-10-07 10:30:51.51
536,2021-07-08,00:00,164026,151923,151158,2034,10069,10487596,10802780,10651622,1.539915705,2021-07-08 00:00:00.000,2021-10-07 10:30:51.51
535,2021-07-07,00:00,162751,151500,142748,2033,9218,10461001,10766500,10623752,1.531954059,2021-07-07 00:00:00.000,2021-10-07 10:30:51.51
534,2021-07-06,00:00,161540,150759,141699,2032,8749,10432476,10735715,10594016,1.52482307,2021-07-06 00:00:00.000,2021-10-07 10:30:51.51
533,2021-07-05,00:00,160794,150043,134893,2028,8723,10404446,10700133,10565240,1.521915262,2021-07-05 00:00:00.000,2021-10-07 10:30:51.51
532,2021-07-04,00:00,160083,149613,136297,2026,8444,10388744,10685124,10548827,1.517543135,2021-07-04 00:00:00.000,2021-10-07 10:30:51.51
531,2021-07-03,00:00,159340,149131,133909,2025,8184,10377367,10670616,10536707,1.512237172,2021-07-03 00:00:00.000,2021-10-07 10:30:51.51
530,2021-07-02,00:00,158546,148318,130666,2024,8204,10352389,10641601,10510935,1.508391023,2021-07-02 00:00:00.000,2021-10-07 10:30:51.51
529,2021-07-01,00:00,157721,148024,124925,2021,7676,10331669,10614315,10489390,1.503624138,2021-07-01 00:00:00.000,2021-10-07 10:30:51.51
528,2021-06-30,00:00,156960,147692,114110,2018,7250,10308001,10579071,10464961,1.499862255,2021-06-30 00:00:00.000,2021-10-07 10:30:51.51
527,2021-06-29,00:00,156166,147075,116858,2017,7074,10282716,10555740,10438882,1.496003116,2021-06-29 00:00:00.000,2021-10-07 10:30:51.51
526,2021-06-28,00:00,155571,146672,114843,2015,6884,10250514,10520928,10406085,1.495000281,2021-06-28 00:00:00.000,2021-10-07 10:30:51.51
525,2021-06-27,00:00,155070,146337,116376,2013,6720,10237231,10508677,10392301,1.492162323,2021-06-27 00:00:00.000,2021-10-07 10:30:51.51
524,2021-06-26,00:00,154456,145986,114573,2012,6458,10226486,10495515,10380942,1.487880387,2021-06-26 00:00:00.000,2021-10-07 10:30:51.51
523,2021-06-25,00:00,153788,145385,122188,2009,6394,10190568,10466544,10344356,1.486685106,2021-06-25 00:00:00.000,2021-10-07 10:30:51.51
522,2021-06-24,00:00,153154,144783,120971,2008,6363,10164656,10438781,10317810,1.484365384,2021-06-24 00:00:00.000,2021-10-07 10:30:51.51
521,2021-06-23,00:00,152544,144373,129791,2007,6164,10127613,10409948,10280157,1.483868388,2021-06-23 00:00:00.000,2021-10-07 10:30:51.51
520,2021-06-22,00:00,151899,143811,127127,2006,6082,10101016,10380042,10252915,1.481520134,2021-06-22 00:00:00.000,2021-10-07 10:30:51.51
519,2021-06-21,00:00,151505,143257,128433,2004,6244,10066108,10346046,10217613,1.48278272,2021-06-21 00:00:00.000,2021-10-07 10:30:51.51
518,2021-06-20,00:00,151148,142887,131062,2002,6259,10053423,10335633,10204571,1.481179366,2021-06-20 00:00:00.000,2021-10-07 10:30:51.51
517,2021-06-19,00:00,150719,142379,128721,1997,6343,10043713,10323153,10194432,1.478444312,2021-06-19 00:00:00.000,2021-10-07 10:30:51.51
516,2021-06-18,00:00,150237,141809,125837,1996,6432,10017973,10294047,10168210,1.477516692,2021-06-18 00:00:00.000,2021-10-07 10:30:51.51
515,2021-06-17,00:00,149730,141022,121319,1994,6714,9986786,10257835,10136516,1.477134747,2021-06-17 00:00:00.000,2021-10-07 10:30:51.51
514,2021-06-16,00:00,149190,140431,118764,1993,6766,9961429,10229383,10110619,1.475577311,2021-06-16 00:00:00.000,2021-10-07 10:30:51.51
513,2021-06-15,00:00,148645,139726,123664,1992,6927,9924159,10196468,10072804,1.475706268,2021-06-15 00:00:00.000,2021-10-07 10:30:51.51
512,2021-06-14,00:00,148272,139015,123424,1988,7269,9893800,10165496,10042072,1.476508035,2021-06-14 00:00:00.000,2021-10-07 10:30:51.51
511,2021-06-13,00:00,147873,138572,124517,1985,7316,9880516,10152906,10028389,1.474543917,2021-06-13 00:00:00.000,2021-10-07 10:30:51.51
510,2021-06-12,00:00,147421,138030,122200,1982,7409,9870913,10140534,10018334,1.47151213,2021-06-12 00:00:00.000,2021-10-07 10:30:51.51
509,2021-06-11,00:00,146856,137217,133753,1981,7658,9830454,10111063,9977310,1.471899741,2021-06-11 00:00:00.000,2021-10-07 10:30:51.51
508,2021-06-10,00:00,146300,136705,130327,1979,7616,9800234,10076861,9946534,1.470864122,2021-06-10 00:00:00.000,2021-10-07 10:30:51.51
507,2021-06-09,00:00,145690,136166,131424,1977,7547,9767668,10044782,9913358,1.469633196,2021-06-09 00:00:00.000,2021-10-07 10:30:51.51
506,2021-06-08,00:00,145088,135404,139260,1975,7709,9724234,10008582,9869322,1.470090853,2021-06-08 00:00:00.000,2021-10-07 10:30:51.51
505,2021-06-07,00:00,144634,134852,136526,1974,7808,9691135,9972295,9835769,1.470490004,2021-06-07 00:00:00.000,2021-10-07 10:30:51.51
504,2021-06-06,00:00,144149,134254,136465,1973,7922,9679081,9959695,9823230,1.467429756,2021-06-06 00:00:00.000,2021-10-07 10:30:51.51
503,2021-06-05,00:00,143593,133755,137164,1971,7867,9665195,9945952,9808788,1.463921944,2021-06-05 00:00:00.000,2021-10-07 10:30:51.51
502,2021-06-04,00:00,142849,133278,133844,1969,7602,9634629,9911322,9777478,1.461000475,2021-06-04 00:00:00.000,2021-10-07 10:30:51.51
501,2021-06-03,00:00,142154,132690,129822,1968,7496,9600346,9872322,9742500,1.459112138,2021-06-03 00:00:00.000,2021-10-07 10:30:51.51
500,2021-06-02,00:00,141473,132061,128917,1965,7447,9563958,9834348,9705431,1.457668392,2021-06-02 00:00:00.000,2021-10-07 10:30:51.51
499,2021-06-01,00:00,140796,131457,127612,1963,7376,9529992,9798400,9670788,1.455889634,2021-06-01 00:00:00.000,2021-10-07 10:30:51.51
498,2021-05-31,00:00,140337,130817,127953,1959,7561,9492866,9761156,9633203,1.4568051768,2021-05-30 00:00:00.0,2021-10-14 13:48:56.821
497,2021-05-30,00:00,139907,130374,126493,1957,7576,9481212,9747612,9621119,1.454165571,2021-05-30 00:00:00.000,2021-10-07 10:30:51.51
496,2021-05-29,00:00,139427,129731,123790,1951,7745,9470371,9733588,9609798,1.450883775,2021-05-29 00:00:00.000,2021-10-07 10:30:51.51
495,2021-05-28,00:00,138894,128750,122872,1946,8198,9440687,9702453,9579581,1.449896399,2021-05-28 00:00:00.000,2021-10-07 10:30:51.51
494,2021-05-27,00:00,138307,128169,122659,1943,8195,9404724,9665690,9543031,1.449298446,2021-05-27 00:00:00.000,2021-10-07 10:30:51.51
493,2021-05-26,00:00,137678,127562,121069,1940,8176,9370708,9629455,9508386,1.447963934,2021-05-26 00:00:00.000,2021-10-07 10:30:51.51
492,2021-05-25,00:00,136973,126983,117098,1938,8052,9338655,9592726,9475628,1.445529521,2021-05-25 00:00:00.000,2021-10-07 10:30:51.51
491,2021-05-24,00:00,136457,126418,120704,1934,8105,9296451,9553612,9432908,1.446605861,2021-05-24 00:00:00.000,2021-10-07 10:30:51.51
490,2021-05-23,00:00,135927,125831,122235,1931,8165,9278136,9536298,9414063,1.443871791,2021-05-23 00:00:00.000,2021-10-07 10:30:51.51
489,2021-05-22,00:00,135342,125024,117558,1926,8392,9268065,9520965,9403407,1.439286846,2021-05-22 00:00:00.000,2021-10-07 10:30:51.51
488,2021-05-21,00:00,134676,124150,114144,1922,8604,9238287,9487107,9372963,1.4368562,2021-05-21 00:00:00.000,2021-10-07 10:30:51.51
487,2021-05-20,00:00,134115,123649,108873,1916,8550,9204369,9447357,9338484,1.436153877,2021-05-20 00:00:00.000,2021-10-07 10:30:51.51
486,2021-05-19,00:00,133469,123224,104494,1912,8333,9190680,9428643,9324149,1.431433582,2021-05-19 00:00:00.000,2021-10-07 10:30:51.51
485,2021-05-18,00:00,132815,122615,103413,1904,8296,9158775,9395003,9291590,1.429410897,2021-05-18 00:00:00.000,2021-10-07 10:30:51.51
484,2021-05-17,00:00,132287,122151,101804,1903,8233,9119208,9353299,9251495,1.429898627,2021-05-17 00:00:00.000,2021-10-07 10:30:51.51
483,2021-05-16,00:00,131668,121743,101663,1900,8025,9103282,9336613,9234950,1.425757584,2021-05-16 00:00:00.000,2021-10-07 10:30:51.51
482,2021-05-15,00:00,131058,121270,99216,1896,7892,9088819,9319093,9219877,1.421472325,2021-05-15 00:00:00.000,2021-10-07 10:30:51.51
481,2021-05-14,00:00,130377,120384,95208,1893,8100,9055705,9281290,9186082,1.419288441,2021-05-14 00:00:00.000,2021-10-07 10:30:51.51
480,2021-05-13,00:00,129630,119892,87517,1891,7847,9024005,9241152,9153635,1.416158717,2021-05-13 00:00:00.000,2021-10-07 10:30:51.51
479,2021-05-12,00:00,128915,119360,84279,1884,7671,8988344,9201538,9117259,1.413966632,2021-05-12 00:00:00.000,2021-10-07 10:30:51.51
478,2021-05-11,00:00,128281,118706,84628,1879,7696,8951374,9164283,9079655,1.412840025,2021-05-11 00:00:00.000,2021-10-07 10:30:51.51
477,2021-05-10,00:00,127771,117832,83398,1875,8064,8910889,9122058,9038660,1.413605557,2021-05-10 00:00:00.000,2021-10-07 10:30:51.51
476,2021-05-09,00:00,127308,117411,81280,1874,8023,8897182,9105770,9024490,1.410694676,2021-05-09 00:00:00.000,2021-10-07 10:30:51.51
475,2021-05-08,00:00,126744,116868,78259,1865,8011,8884162,9089165,9010906,1.406562226,2021-05-08 00:00:00.000,2021-10-07 10:30:51.51
474,2021-05-07,00:00,126043,116008,78896,1860,8175,8846414,9051353,8972457,1.404776863,2021-05-07 00:00:00.000,2021-10-07 10:30:51.51
473,2021-05-06,00:00,125518,115477,77055,1851,8190,8808418,9010991,8933936,1.404957457,2021-05-06 00:00:00.000,2021-10-07 10:30:51.51
472,2021-05-05,00:00,124944,114931,78995,1847,8166,8790129,8994068,8915073,1.401491609,2021-05-05 00:00:00.000,2021-10-07 10:30:51.51
471,2021-05-04,00:00,124268,114115,78096,1840,8313,8754790,8957154,8879058,1.399562882,2021-05-04 00:00:00.000,2021-10-07 10:30:51.51
470,2021-05-03,00:00,123727,113345,89022,1834,8548,8702576,8915325,8826303,1.401798692,2021-05-03 00:00:00.000,2021-10-07 10:30:51.51
469,2021-05-02,00:00,123239,112855,86607,1833,8551,8688387,8898233,8811626,1.398595447,2021-05-02 00:00:00.000,2021-10-07 10:30:51.51
468,2021-05-01,00:00,122633,112328,85212,1831,8474,8675542,8883387,8798175,1.393845883,2021-05-01 00:00:00.000,2021-10-07 10:30:51.51
467,2021-04-30,00:00,122006,111412,82511,1828,8766,8643774,8848291,8765780,1.391844194,2021-04-30 00:00:00.000,2021-10-07 10:30:51.51
466,2021-04-29,00:00,121345,110778,80392,1825,8742,8604041,8805778,8725386,1.390712113,2021-04-29 00:00:00.000,2021-10-07 10:30:51.51
465,2021-04-28,00:00,120666,110239,77166,1821,8606,8568664,8766496,8689330,1.388668632,2021-04-28 00:00:00.000,2021-10-07 10:30:51.51
464,2021-04-27,00:00,119897,109686,76508,1820,8391,8525203,8721608,8645100,1.386878116,2021-04-27 00:00:00.000,2021-10-07 10:30:51.51
463,2021-04-26,00:00,119385,108841,78084,1817,8727,8475508,8672977,8594893,1.389022528,2021-04-26 00:00:00.000,2021-10-07 10:30:51.51
462,2021-04-25,00:00,118886,108465,77560,1813,8608,8458344,8654790,8577230,1.386065198,2021-04-25 00:00:00.000,2021-10-07 10:30:51.51
461,2021-04-24,00:00,118242,107771,78269,1812,8659,8436411,8632922,8554653,1.382195163,2021-04-24 00:00:00.000,2021-10-07 10:30:51.51
460,2021-04-23,00:00,117457,107061,39939,1811,8585,8426133,8583529,8543590,1.374796777,2021-04-23 00:00:00.000,2021-10-07 10:30:51.51
459,2021-04-22,00:00,116660,106449,67139,1808,8403,8353705,8537504,8470365,1.377272408,2021-04-22 00:00:00.000,2021-10-07 10:30:51.51
458,2021-04-21,00:00,115925,105867,67211,1806,8252,8314457,8497593,8430382,1.375085969,2021-04-21 00:00:00.000,2021-10-07 10:30:51.51
457,2021-04-20,00:00,115194,105217,66590,1802,8175,8276807,8458591,8392001,1.372664279,2021-04-20 00:00:00.000,2021-10-07 10:30:51.51
456,2021-04-19,00:00,114645,104466,70763,1801,8378,8229412,8414820,8344057,1.373971918,2021-04-19 00:00:00.000,2021-10-07 10:30:51.51
455,2021-04-18,00:00,114113,103998,72191,1797,8318,8209761,8396065,8323874,1.37091215,2021-04-18 00:00:00.000,2021-10-07 10:30:51.51
454,2021-04-17,00:00,113442,103585,71039,1794,8063,8193297,8377778,8306739,1.365662265,2021-04-17 00:00:00.000,2021-10-07 10:30:51.51
453,2021-04-16,00:00,112784,103049,70883,1790,7945,8149664,8333331,8262448,1.365019181,2021-04-16 00:00:00.000,2021-10-07 10:30:51.51
452,2021-04-15,00:00,112111,102501,70221,1788,7822,8108792,8291124,8220903,1.363730967,2021-04-15 00:00:00.000,2021-10-07 10:30:51.51
451,2021-04-14,00:00,111413,101970,74627,1782,7661,8059346,8245386,8170759,1.363557535,2021-04-14 00:00:00.000,2021-10-07 10:30:51.51
450,2021-04-13,00:00,110682,101318,85584,1775,7589,8004251,8200517,8114933,1.36392993,2021-04-13 00:00:00.000,2021-10-07 10:30:51.51
449,2021-04-12,00:00,110140,100790,95248,1770,7580,7947393,8152781,8057533,1.366919627,2021-04-12 00:00:00.000,2021-10-07 10:30:51.51
448,2021-04-11,00:00,109553,100102,91909,1768,7683,7928068,8129530,8037621,1.363002809,2021-04-11 00:00:00.000,2021-10-07 10:30:51.51
447,2021-04-10,00:00,108939,99291,90014,1765,7883,7907675,8106628,8016614,1.358915373,2021-04-10 00:00:00.000,2021-10-07 10:30:51.51
446,2021-04-09,00:00,108262,98778,81912,1764,7720,7868937,8059111,7977199,1.357143027,2021-04-09 00:00:00.000,2021-10-07 10:30:51.51
445,2021-04-08,00:00,107591,98351,77994,1758,7482,7826834,8012419,7934425,1.356002483,2021-04-08 00:00:00.000,2021-10-07 10:30:51.51
444,2021-04-07,00:00,106891,97920,74642,1756,7215,7784632,7966165,7891523,1.354504067,2021-04-07 00:00:00.000,2021-10-07 10:30:51.51
443,2021-04-06,00:00,106223,97352,79155,1752,7119,7735910,7921288,7842133,1.354516686,2021-04-06 00:00:00.000,2021-10-07 10:30:51.51
442,2021-04-05,00:00,105746,96890,80497,1748,7108,7682575,7868818,7788321,1.35775092,2021-04-05 00:00:00.000,2021-10-07 10:30:51.51
441,2021-04-04,00:00,105273,96578,79799,1744,6951,7664402,7849474,7769675,1.354921538,2021-04-04 00:00:00.000,2021-10-07 10:30:51.51
440,2021-04-03,00:00,104730,96185,75288,1740,6805,7649581,7829599,7754311,1.350603555,2021-04-03 00:00:00.000,2021-10-07 10:30:51.51
439,2021-04-02,00:00,104187,95847,70752,1737,6603,7613354,7788293,7717541,1.350002546,2021-04-02 00:00:00.000,2021-10-07 10:30:51.51
438,2021-04-01,00:00,103630,95426,65659,1735,6469,7578012,7747301,7681642,1.349060526,2021-04-01 00:00:00.000,2021-10-07 10:30:51.51
437,2021-03-31,00:00,103079,95017,71302,1731,6331,7533417,7707798,7636496,1.349820651,2021-03-31 00:00:00.000,2021-10-07 10:30:51.51
436,2021-03-30,00:00,102573,94550,78424,1729,6294,7483000,7663997,7585573,1.352211626,2021-03-30 00:00:00.000,2021-10-07 10:30:51.51
435,2021-03-29,00:00,102126,94110,78938,1726,6290,7435264,7616328,7537390,1.354925246,2021-03-29 00:00:00.000,2021-10-07 10:30:51.51
434,2021-03-28,00:00,101744,93843,78605,1722,6179,7415245,7595594,7516989,1.353520672,2021-03-28 00:00:00.000,2021-10-07 10:30:51.51
433,2021-03-27,00:00,101262,93464,75174,1721,6077,7396130,7572566,7497392,1.350629659,2021-03-27 00:00:00.000,2021-10-07 10:30:51.51
432,2021-03-26,00:00,100757,92612,77409,1716,6429,7351235,7529401,7451992,1.35208143,2021-03-26 00:00:00.000,2021-10-07 10:30:51.51
431,2021-03-25,00:00,100268,92053,86983,1709,6506,7298607,7485858,7398875,1.355178997,2021-03-25 00:00:00.000,2021-10-07 10:30:51.51
430,2021-03-24,00:00,99838,91545,94326,1707,6586,7247045,7441209,7346883,1.358916428,2021-03-24 00:00:00.000,2021-10-07 10:30:51.51
429,2021-03-23,00:00,99410,91064,100172,1704,6642,7201407,7400989,7300817,1.361628431,2021-03-23 00:00:00.000,2021-10-07 10:30:51.51
428,2021-03-22,00:00,99064,90597,103132,1697,6770,7153767,7355963,7252831,1.365866653,2021-03-22 00:00:00.000,2021-10-07 10:30:51.51
427,2021-03-21,00:00,98649,90314,98308,1696,6639,7135756,7332713,7234405,1.363609032,2021-03-21 00:00:00.000,2021-10-07 10:30:51.51
426,2021-03-20,00:00,98193,89935,93018,1693,6565,7117738,7308949,7215931,1.36078075,2021-03-20 00:00:00.000,2021-10-07 10:30:51.51
425,2021-03-19,00:00,97746,89508,88341,1690,6548,7078853,7264940,7176599,1.362010055,2021-03-19 00:00:00.000,2021-10-07 10:30:51.51
424,2021-03-18,00:00,97283,89164,89722,1688,6431,7031081,7218086,7128364,1.364731094,2021-03-18 00:00:00.000,2021-10-07 10:30:51.51
423,2021-03-17,00:00,96838,88799,83462,1686,6353,6991209,7171509,7088047,1.366215546,2021-03-17 00:00:00.000,2021-10-07 10:30:51.51
422,2021-03-16,00:00,96369,88240,78044,1678,6451,6951663,7126076,7048032,1.367317856,2021-03-16 00:00:00.000,2021-10-07 10:30:51.51
421,2021-03-15,00:00,96006,87740,71590,1675,6591,6917343,7084939,7013349,1.368903786,2021-03-15 00:00:00.000,2021-10-07 10:30:51.51
420,2021-03-14,00:00,95627,87393,69843,1669,6565,6900930,7066400,6996557,1.366772257,2021-03-14 00:00:00.000,2021-10-07 10:30:51.51
419,2021-03-13,00:00,95168,86613,67874,1667,6888,6883739,7046781,6978907,1.36365193,2021-03-13 00:00:00.000,2021-10-07 10:30:51.51
418,2021-03-12,00:00,94678,85732,68738,1662,7284,6849247,7012663,6943925,1.363465187,2021-03-12 00:00:00.000,2021-10-07 10:30:51.51
417,2021-03-11,00:00,94190,84665,68248,1652,7873,6814546,6976984,6908736,1.363346349,2021-03-11 00:00:00.000,2021-10-07 10:30:51.51
416,2021-03-10,00:00,93725,84301,70278,1648,7776,6774880,6938883,6868605,1.364541999,2021-03-10 00:00:00.000,2021-10-07 10:30:51.51
415,2021-03-09,00:00,93255,83889,70501,1645,7721,6739227,6902983,6832482,1.364877361,2021-03-09 00:00:00.000,2021-10-07 10:30:51.51
414,2021-03-08,00:00,92809,83462,67394,1642,7705,6701605,6861808,6794414,1.365960332,2021-03-08 00:00:00.000,2021-10-07 10:30:51.51
413,2021-03-07,00:00,92463,83207,66396,1634,7622,6684266,6843125,6776729,1.364419324,2021-03-07 00:00:00.000,2021-10-07 10:30:51.51
412,2021-03-06,00:00,92047,82901,65171,1632,7514,6664724,6821942,6756771,1.362292728,2021-03-06 00:00:00.000,2021-10-07 10:30:51.51
411,2021-03-05,00:00,91629,82545,63707,1627,7457,6633674,6789010,6725303,1.362451625,2021-03-05 00:00:00.000,2021-10-07 10:30:51.51
410,2021-03-04,00:00,91231,82148,60089,1619,7464,6600579,6751899,6691810,1.363323226,2021-03-04 00:00:00.000,2021-10-07 10:30:51.51
409,2021-03-03,00:00,90807,81687,65867,1612,7508,6559528,6716202,6650335,1.365450011,2021-03-03 00:00:00.000,2021-10-07 10:30:51.51
408,2021-03-02,00:00,90363,81324,73432,1606,7433,6518180,6681975,6608543,1.367366453,2021-03-02 00:00:00.000,2021-10-07 10:30:51.51
407,2021-03-01,00:00,90019,81056,73745,1605,7358,6501990,6665754,6592009,1.365577626,2021-03-01 00:00:00.000,2021-10-07 10:30:51.51
406,2021-02-28,00:00,89664,80683,72889,1603,7378,6486452,6649005,6576116,1.363479598,2021-02-28 00:00:00.000,2021-10-07 10:30:51.51
405,2021-02-27,00:00,89309,80318,68989,1595,7396,6468916,6627214,6558225,1.361786154,2021-02-27 00:00:00.000,2021-10-07 10:30:51.51
404,2021-02-26,00:00,88894,79865,68942,1585,7444,6432229,6590065,6521123,1.363170117,2021-02-26 00:00:00.000,2021-10-07 10:30:51.51
403,2021-02-25,00:00,88507,79473,68672,1581,7453,6394034,6551213,6482541,1.365313386,2021-02-25 00:00:00.000,2021-10-07 10:30:51.51
402,2021-02-24,00:00,88112,79035,74988,1576,7501,6347887,6510987,6435999,1.369049312,2021-02-24 00:00:00.000,2021-10-07 10:30:51.51
401,2021-02-23,00:00,87672,78379,74065,1573,7720,6310941,6472678,6398613,1.370171942,2021-02-23 00:00:00.000,2021-10-07 10:30:51.51
400,2021-02-22,00:00,87316,77872,72461,1562,7882,6269366,6429143,6356682,1.373609691,2021-02-22 00:00:00.000,2021-10-07 10:30:51.51
399,2021-02-21,00:00,86984,77502,73356,1557,7925,6250999,6411339,6337983,1.372424003,2021-02-21 00:00:00.000,2021-10-07 10:30:51.51
398,2021-02-20,00:00,86568,77071,76137,1553,7944,6227925,6390630,6314493,1.37094142,2021-02-20 00:00:00.000,2021-10-07 10:30:51.51
397,2021-02-19,00:00,86120,76503,71116,1550,8067,6188755,6345991,6274875,1.372457619,2021-02-19 00:00:00.000,2021-10-07 10:30:51.51
396,2021-02-18,00:00,85559,75887,70720,1544,8128,6146934,6303213,6232493,1.372789348,2021-02-18 00:00:00.000,2021-10-07 10:30:51.51
395,2021-02-17,00:00,84938,75350,72410,1538,8050,6103218,6260566,6188156,1.372589831,2021-02-17 00:00:00.000,2021-10-07 10:30:51.51
394,2021-02-16,00:00,84317,74541,76897,1534,8242,6052275,6213489,6136592,1.374003682,2021-02-16 00:00:00.000,2021-10-07 10:30:51.51
393,2021-02-15,00:00,83860,73786,80146,1527,8547,5998853,6162859,6082713,1.378661134,2021-02-15 00:00:00.000,2021-10-07 10:30:51.51
392,2021-02-14,00:00,83517,73551,78200,1522,8444,5978368,6140085,6061885,1.377739762,2021-02-14 00:00:00.000,2021-10-07 10:30:51.51
391,2021-02-13,00:00,83191,73219,70251,1514,8458,5961894,6115336,6045085,1.376175852,2021-02-13 00:00:00.000,2021-10-07 10:30:51.51
390,2021-02-12,00:00,82829,72927,80861,1507,8395,5929678,6093368,6012507,1.377611702,2021-02-12 00:00:00.000,2021-10-07 10:30:51.51
389,2021-02-11,00:00,82426,72627,81614,1496,8303,5905967,6070007,5988393,1.376429369,2021-02-11 00:00:00.000,2021-10-07 10:30:51.51
388,2021-02-10,00:00,81922,72210,80076,1486,8226,5868024,6030022,5949946,1.376852832,2021-02-10 00:00:00.000,2021-10-07 10:30:51.51
387,2021-02-09,00:00,81478,71661,82630,1482,8335,5823296,5987404,5904774,1.379866528,2021-02-09 00:00:00.000,2021-10-07 10:30:51.51
386,2021-02-08,00:00,81175,71204,84843,1474,8497,5772177,5938195,5853352,1.386812206,2021-02-08 00:00:00.000,2021-10-07 10:30:51.51
385,2021-02-07,00:00,80887,70840,90751,1471,8576,5745336,5916974,5826223,1.388326537,2021-02-07 00:00:00.000,2021-10-07 10:30:51.51
384,2021-02-06,00:00,80516,70490,97677,1464,8562,5715159,5893352,5795675,1.389242841,2021-02-06 00:00:00.000,2021-10-07 10:30:51.51
383,2021-02-05,00:00,80126,70088,107457,1459,8579,5659594,5847177,5739720,1.395991442,2021-02-05 00:00:00.000,2021-10-07 10:30:51.51
382,2021-02-04,00:00,79756,69687,120538,1448,8621,5602800,5803094,5682556,1.403523344,2021-02-04 00:00:00.000,2021-10-07 10:30:51.51
381,2021-02-03,00:00,79305,69280,138849,1441,8584,5538559,5756713,5617864,1.411657527,2021-02-03 00:00:00.000,2021-10-07 10:30:51.51
380,2021-02-02,00:00,78838,68756,154265,1435,8647,5478309,5711412,5557147,1.418677606,2021-02-02 00:00:00.000,2021-10-07 10:30:51.51
379,2021-02-01,00:00,78502,68287,149456,1425,8790,5433883,5661841,5512385,1.424102272,2021-02-01 00:00:00.000,2021-10-07 10:30:51.51
378,2021-01-31,00:00,78197,67837,149550,1420,8940,5413070,5640817,5491267,1.424024729,2021-01-31 00:00:00.000,2021-10-07 10:30:51.51
377,2021-01-30,00:00,77843,67097,145795,1414,9332,5392889,5616527,5470732,1.422899166,2021-01-30 00:00:00.000,2021-10-07 10:30:51.51
376,2021-01-29,00:00,77387,66480,142753,1399,9508,5349121,5569261,5426508,1.426092065,2021-01-29 00:00:00.000,2021-10-07 10:30:51.51
375,2021-01-28,00:00,76918,65996,139424,1386,9536,5305844,5522186,5382762,1.428968994,2021-01-28 00:00:00.000,2021-10-07 10:30:51.51
374,2021-01-27,00:00,76421,65456,138427,1378,9587,5254396,5469244,5330817,1.433570126,2021-01-27 00:00:00.000,2021-10-07 10:30:51.51
373,2021-01-26,00:00,75862,64768,138624,1371,9723,5208274,5422760,5284136,1.435655706,2021-01-26 00:00:00.000,2021-10-07 10:30:51.51
372,2021-01-25,00:00,75513,62930,134549,1360,11223,5166021,5376083,5241534,1.440666034,2021-01-25 00:00:00.000,2021-10-07 10:30:51.51
371,2021-01-24,00:00,75076,62503,135765,1349,11224,5143505,5354346,5218581,1.438628623,2021-01-24 00:00:00.000,2021-10-07 10:30:51.51
370,2021-01-23,00:00,74684,62016,136629,1337,11331,5118391,5329704,5193075,1.438145992,2021-01-23 00:00:00.000,2021-10-07 10:30:51.51
369,2021-01-22,00:00,74253,61384,133132,1328,11541,5074835,5282220,5149088,1.442061196,2021-01-22 00:00:00.000,2021-10-07 10:30:51.51
368,2021-01-21,00:00,73907,60816,141070,1316,11775,5022625,5237602,5096532,1.45014296,2021-01-21 00:00:00.000,2021-10-07 10:30:51.51
367,2021-01-20,00:00,73507,60144,148141,1300,12063,4970476,5192124,5043983,1.457320534,2021-01-20 00:00:00.000,2021-10-07 10:30:51.51
366,2021-01-19,00:00,73103,59434,154345,1283,12386,4912872,5140320,4985975,1.466172614,2021-01-19 00:00:00.000,2021-10-07 10:30:51.51
365,2021-01-18,00:00,72717,58677,158035,1264,12776,4856462,5087214,4929179,1.475235531,2021-01-18 00:00:00.000,2021-10-07 10:30:51.51
364,2021-01-17,00:00,72328,58205,159385,1249,12874,4829571,5061284,4901899,1.475509797,2021-01-17 00:00:00.000,2021-10-07 10:30:51.51
363,2021-01-16,00:00,71808,57512,155639,1236,13060,4804817,5032264,4876625,1.472493784,2021-01-16 00:00:00.000,2021-10-07 10:30:51.51
362,2021-01-15,00:00,71228,56493,162323,1217,13518,4744517,4978068,4815745,1.479065025,2021-01-15 00:00:00.000,2021-10-07 10:30:51.51
361,2021-01-14,00:00,70716,55672,169742,1195,13849,4684895,4925353,4755611,1.487001355,2021-01-14 00:00:00.000,2021-10-07 10:30:51.51
360,2021-01-13,00:00,70192,54607,182914,1185,14400,4619200,4872306,4689392,1.496825175,2021-01-13 00:00:00.000,2021-10-07 10:30:51.51
359,2021-01-12,00:00,69631,53537,186770,1165,14929,4557678,4814079,4627309,1.504783882,2021-01-12 00:00:00.000,2021-10-07 10:30:51.51
358,2021-01-11,00:00,69094,52523,189763,1140,15431,4492822,4751679,4561916,1.514582908,2021-01-11 00:00:00.000,2021-10-07 10:30:51.51
357,2021-01-10,00:00,68643,50387,191454,1125,17131,4463360,4723457,4532003,1.5146283,2021-01-10 00:00:00.000,2021-10-07 10:30:51.51
356,2021-01-09,00:00,67986,49283,185923,1100,17603,4435701,4689610,4503687,1.509563165,2021-01-09 00:00:00.000,2021-10-07 10:30:51.51
355,2021-01-08,00:00,67345,48329,190452,1081,17935,4372201,4629998,4439546,1.516934389,2021-01-08 00:00:00.000,2021-10-07 10:30:51.51
354,2021-01-07,00:00,66671,47622,191762,1046,18003,4311369,4569802,4378040,1.522850408,2021-01-07 00:00:00.000,2021-10-07 10:30:51.51
353,2021-01-06,00:00,65802,46965,192082,1027,17810,4246976,4504860,4312778,1.525745123,2021-01-06 00:00:00.000,2021-10-07 10:30:51.51
352,2021-01-05,00:00,64964,46137,193751,1007,17820,4180639,4439354,4245603,1.530147779,2021-01-05 00:00:00.000,2021-10-07 10:30:51.51
351,2021-01-04,00:00,64250,45208,190732,981,18061,4121620,4376602,4185870,1.534925834,2021-01-04 00:00:00.000,2021-10-07 10:30:51.51
350,2021-01-03,00:00,63230,44477,186472,962,17791,4091130,4340832,4154360,1.522015425,2021-01-03 00:00:00.000,2021-10-07 10:30:51.51
349,2021-01-02,00:00,62573,43546,179387,942,18085,4060832,4302792,4123405,1.517507982,2021-01-02 00:00:00.000,2021-10-07 10:30:51.51
348,2021-01-01,00:00,61753,42929,176927,917,17907,4030632,4269312,4092385,1.508973374,2021-01-01 00:00:00.000,2021-10-07 10:30:51.51
347,2020-12-31,00:00,60726,42232,170338,900,17594,3982810,4213874,4043536,1.501804361,2020-12-31 00:00:00.000,2021-10-07 10:30:51.51
346,2020-12-30,00:00,59759,41411,171771,879,17469,3927986,4159516,3987745,1.498566232,2020-12-30 00:00:00.000,2021-10-07 10:30:51.51
345,2020-12-29,00:00,58709,40685,170962,859,17165,3868502,4098173,3927211,1.494928589,2020-12-29 00:00:00.000,2021-10-07 10:30:51.51
344,2020-12-28,00:00,57665,39249,169878,819,17597,3810757,4038300,3868422,1.490659499,2020-12-28 00:00:00.000,2021-10-07 10:30:51.51
343,2020-12-27,00:00,56859,39020,166976,808,17031,3782571,4006406,3839430,1.48092295,2020-12-27 00:00:00.000,2021-10-07 10:30:51.51
342,2020-12-26,00:00,55889,38514,157012,793,16582,3756508,3969409,3812397,1.465980589,2020-12-26 00:00:00.000,2021-10-07 10:30:51.51
341,2020-12-25,00:00,54758,38028,156789,773,15957,3727805,3939352,3782563,1.447642776,2020-12-25 00:00:00.000,2021-10-07 10:30:51.51
340,2020-12-24,00:00,53518,37400,150533,756,15362,3678154,3882205,3731672,1.434156057,2020-12-24 00:00:00.000,2021-10-07 10:30:51.51
339,2020-12-23,00:00,52533,36710,153109,739,15084,3620923,3826565,3673456,1.430070212,2020-12-23 00:00:00.000,2021-10-07 10:30:51.51
338,2020-12-22,00:00,51443,35912,151129,722,14809,3569853,3772425,3621296,1.420568769,2020-12-22 00:00:00.000,2021-10-07 10:30:51.51
337,2020-12-21,00:00,50577,35139,146438,698,14740,3516841,3713856,3567418,1.417748074,2020-12-21 00:00:00.000,2021-10-07 10:30:51.51
336,2020-12-20,00:00,49653,34709,139475,674,14270,3493963,3683091,3543616,1.401195841,2020-12-20 00:00:00.000,2021-10-07 10:30:51.51
335,2020-12-19,00:00,48557,34322,126233,659,13576,3471455,3646245,3520012,1.379455525,2020-12-19 00:00:00.000,2021-10-07 10:30:51.51
334,2020-12-18,00:00,47512,33966,110618,645,12901,3431665,3589795,3479177,1.365610315,2020-12-18 00:00:00.000,2021-10-07 10:30:51.51
333,2020-12-17,00:00,46448,33595,99258,634,12219,3393132,3538838,3439580,1.350397432,2020-12-17 00:00:00.000,2021-10-07 10:30:51.51
332,2020-12-16,00:00,45434,32934,94784,612,11888,3348549,3488767,3393983,1.338663158,2020-12-16 00:00:00.000,2021-10-07 10:30:51.51
331,2020-12-15,00:00,44356,32548,93473,600,11208,3303389,3441218,3347745,1.324951572,2020-12-15 00:00:00.000,2021-10-07 10:30:51.51
330,2020-12-14,00:00,43476,32092,89247,587,10797,3264314,3397037,3307790,1.314351878,2020-12-14 00:00:00.000,2021-10-07 10:30:51.51
329,2020-12-13,00:00,42758,31803,90127,580,10375,3241708,3374593,3284466,1.301825015,2020-12-13 00:00:00.000,2021-10-07 10:30:51.51
328,2020-12-12,00:00,41728,31482,86742,578,9668,3221392,3349862,3263120,1.278776141,2020-12-12 00:00:00.000,2021-10-07 10:30:51.51
327,2020-12-11,00:00,40778,31147,77688,572,9059,3192745,3311211,3233523,1.261101282,2020-12-11 00:00:00.000,2021-10-07 10:30:51.51
326,2020-12-10,00:00,40089,30626,72764,564,8899,3165093,3277946,3205182,1.250755807,2020-12-10 00:00:00.000,2021-10-07 10:30:51.51
325,2020-12-09,00:00,39409,30167,71274,556,8686,3142536,3253219,3181945,1.238519208,2020-12-09 00:00:00.000,2021-10-07 10:30:51.51
324,2020-12-08,00:00,38739,29640,75080,552,8547,3107497,3221316,3146236,1.231280807,2020-12-08 00:00:00.000,2021-10-07 10:30:51.51
323,2020-12-07,00:00,38152,29293,68010,549,8310,3103205,3209367,3141357,1.214506979,2020-12-07 00:00:00.000,2021-10-07 10:30:51.51
322,2020-12-06,00:00,37537,29120,67716,545,7872,3089605,3194858,3127142,1.200361224,2020-12-06 00:00:00.000,2021-10-07 10:30:51.51
321,2020-12-05,00:00,36906,28907,66267,540,7459,3077314,3180487,3114220,1.185080052,2020-12-05 00:00:00.000,2021-10-07 10:30:51.51
320,2020-12-04,00:00,36329,28599,64017,536,7194,3057061,3157407,3093390,1.174407365,2020-12-04 00:00:00.000,2021-10-07 10:30:51.51
319,2020-12-03,00:00,35701,28341,65788,529,6831,3030395,3131884,3066096,1.164379719,2020-12-03 00:00:00.000,2021-10-07 10:30:51.51
318,2020-12-02,00:00,35161,28053,65154,526,6582,3006653,3106968,3041814,1.155922091,2020-12-02 00:00:00.000,2021-10-07 10:30:51.51
317,2020-12-01,00:00,34650,27875,64892,526,6249,2984453,3083995,3019103,1.147691881,2020-12-01 00:00:00.000,2021-10-07 10:30:51.51
316,2020-11-30,00:00,34199,27612,63365,526,6061,2963606,3061170,2997805,1.140801353,2020-11-30 00:00:00.000,2021-10-07 10:30:51.51
315,2020-11-29,00:00,33761,27506,62829,523,5732,2950318,3046908,2984079,1.131370852,2020-11-29 00:00:00.000,2021-10-07 10:30:51.51
314,2020-11-28,00:00,33311,27328,58794,522,5461,2939835,3031940,2973146,1.120395702,2020-11-28 00:00:00.000,2021-10-07 10:30:51.51
313,2020-11-27,00:00,32808,27097,56637,516,5195,2920054,3009499,2952862,1.111057679,2020-11-27 00:00:00.000,2021-10-07 10:30:51.51
312,2020-11-26,00:00,32253,26944,55361,515,4794,2900368,2987982,2932621,1.099801168,2020-11-26 00:00:00.000,2021-10-07 10:30:51.51
311,2020-11-25,00:00,31672,26819,55838,513,4340,2878832,2966342,2910504,1.088196409,2020-11-25 00:00:00.000,2021-10-07 10:30:51.51
310,2020-11-24,00:00,31290,26716,57769,510,4064,2857277,2946336,2888567,1.083236082,2020-11-24 00:00:00.000,2021-10-07 10:30:51.51
309,2020-11-23,00:00,30941,26532,56455,509,3900,2834676,2922072,2865617,1.079732567,2020-11-23 00:00:00.000,2021-10-07 10:30:51.51
308,2020-11-22,00:00,30670,26461,54029,505,3704,2824128,2908827,2854798,1.074331704,2020-11-22 00:00:00.000,2021-10-07 10:30:51.51
307,2020-11-21,00:00,30340,26361,51345,503,3476,2814998,2896683,2845338,1.066305655,2020-11-21 00:00:00.000,2021-10-07 10:30:51.51
306,2020-11-20,00:00,29954,26260,48143,501,3193,2795283,2873380,2825237,1.060229637,2020-11-20 00:00:00.000,2021-10-07 10:30:51.51
305,2020-11-19,00:00,29606,26094,45525,498,3014,2778664,2853795,2808270,1.05424336,2020-11-19 00:00:00.000,2021-10-07 10:30:51.51
304,2020-11-18,00:00,29281,25969,42688,496,2816,2762363,2834332,2791644,1.048880158,2020-11-18 00:00:00.000,2021-10-07 10:30:51.51
303,2020-11-17,00:00,28996,25856,41202,494,2646,2745555,2815753,2774551,1.045069995,2020-11-17 00:00:00.000,2021-10-07 10:30:51.51
302,2020-11-16,00:00,28766,25755,38314,494,2517,2730609,2797689,2759375,1.042482446,2020-11-16 00:00:00.000,2021-10-07 10:30:51.51
301,2020-11-15,00:00,28544,25688,36378,493,2363,2721954,2786876,2750498,1.037775705,2020-11-15 00:00:00.000,2021-10-07 10:30:51.51
300,2020-11-14,00:00,28336,25633,34692,492,2211,2714259,2777287,2742595,1.033182078,2020-11-14 00:00:00.000,2021-10-07 10:30:51.51
299,2020-11-13,00:00,28131,25532,30119,488,2111,2703159,2761409,2731290,1.029952879,2020-11-13 00:00:00.000,2021-10-07 10:30:51.51
298,2020-11-12,00:00,27940,25400,29284,487,2053,2692546,2749770,2720486,1.027022378,2020-11-12 00:00:00.000,2021-10-07 10:30:51.51
297,2020-11-11,00:00,27797,25261,28688,487,2049,2680047,2736532,2707844,1.026536241,2020-11-11 00:00:00.000,2021-10-07 10:30:51.51
296,2020-11-10,00:00,27652,25155,27855,485,2012,2668452,2723959,2696104,1.025628091,2020-11-10 00:00:00.000,2021-10-07 10:30:51.51
295,2020-11-09,00:00,27552,25025,25802,480,2047,2655844,2709198,2683396,1.02675863,2020-11-09 00:00:00.000,2021-10-07 10:30:51.51
294,2020-11-08,00:00,27426,24965,25648,478,1983,2649805,2702879,2677231,1.024416645,2020-11-08 00:00:00.000,2021-10-07 10:30:51.51
293,2020-11-07,00:00,27283,24908,26217,477,1898,2643748,2697248,2671031,1.021440784,2020-11-07 00:00:00.000,2021-10-07 10:30:51.51
292,2020-11-06,00:00,27194,24818,25629,476,1900,2633490,2686313,2660684,1.02206801,2020-11-06 00:00:00.000,2021-10-07 10:30:51.51
291,2020-11-05,00:00,27049,24732,25062,475,1842,2621594,2673705,2648643,1.021239933,2020-11-05 00:00:00.000,2021-10-07 10:30:51.51
290,2020-11-04,00:00,26924,24613,24255,474,1837,2611080,2662259,2638004,1.020620136,2020-11-04 00:00:00.000,2021-10-07 10:30:51.51
289,2020-11-03,00:00,26807,24505,25815,472,1830,2597237,2649859,2624044,1.021591101,2020-11-03 00:00:00.000,2021-10-07 10:30:51.51
288,2020-11-02,00:00,26732,24391,25524,468,1873,2584394,2636650,2611126,1.023772886,2020-11-02 00:00:00.000,2021-10-07 10:30:51.51
287,2020-11-01,00:00,26635,24353,24838,466,1816,2579157,2630630,2605792,1.02214605,2020-11-01 00:00:00.000,2021-10-07 10:30:51.51
286,2020-10-31,00:00,26511,24307,25678,464,1740,2572303,2624492,2598814,1.020119177,2020-10-31 00:00:00.000,2021-10-07 10:30:51.51
285,2020-10-30,00:00,26384,24223,26373,463,1698,2559474,2612231,2585858,1.020318981,2020-10-30 00:00:00.000,2021-10-07 10:30:51.51
284,2020-10-29,00:00,26271,24163,26148,462,1646,2545559,2597978,2571830,1.021490534,2020-10-29 00:00:00.000,2021-10-07 10:30:51.51
283,2020-10-28,00:00,26146,24068,22904,461,1617,2533910,2582960,2560056,1.021305784,2020-10-28 00:00:00.000,2021-10-07 10:30:51.51
282,2020-10-27,00:00,26043,23975,23003,460,1608,2518541,2567587,2544584,1.023467883,2020-10-27 00:00:00.000,2021-10-07 10:30:51.51
281,2020-10-26,00:00,25955,23895,20763,457,1603,2505546,2552264,2531501,1.025281049,2020-10-26 00:00:00.000,2021-10-07 10:30:51.51
280,2020-10-25,00:00,25836,23863,21682,457,1516,2498628,2546146,2524464,1.023425171,2020-10-25 00:00:00.000,2021-10-07 10:30:51.51
279,2020-10-24,00:00,25775,23828,21888,457,1490,2493016,2540679,2518791,1.023308405,2020-10-24 00:00:00.000,2021-10-07 10:30:51.51
278,2020-10-23,00:00,25698,23711,20430,455,1532,2482493,2528621,2508191,1.024563121,2020-10-23 00:00:00.000,2021-10-07 10:30:51.51
277,2020-10-22,00:00,25543,23641,19813,453,1449,2469969,2515325,2495512,1.02355749,2020-10-22 00:00:00.000,2021-10-07 10:30:51.51
276,2020-10-21,00:00,25422,23576,19493,450,1396,2458574,2503489,2483996,1.0234316,2020-10-21 00:00:00.000,2021-10-07 10:30:51.51
275,2020-10-20,00:00,25333,23458,19379,447,1428,2446599,2491311,2471932,1.024825926,2020-10-20 00:00:00.000,2021-10-07 10:30:51.51
274,2020-10-19,00:00,25275,23360,16763,444,1471,2437188,2479226,2462463,1.026411361,2020-10-19 00:00:00.000,2021-10-07 10:30:51.51
273,2020-10-18,00:00,25199,23305,17781,444,1450,2431549,2474529,2456748,1.025705526,2020-10-18 00:00:00.000,2021-10-07 10:30:51.51
272,2020-10-17,00:00,25108,23252,17318,443,1413,2426101,2468527,2451209,1.02431086,2020-10-17 00:00:00.000,2021-10-07 10:30:51.51
271,2020-10-16,00:00,25035,23173,17355,441,1421,2417036,2459426,2442071,1.025154469,2020-10-16 00:00:00.000,2021-10-07 10:30:51.51
270,2020-10-15,00:00,24988,23075,18262,439,1474,2407489,2450739,2432477,1.027265623,2020-10-15 00:00:00.000,2021-10-07 10:30:51.51
269,2020-10-14,00:00,24878,23023,18396,438,1417,2398169,2441443,2423047,1.02672379,2020-10-14 00:00:00.000,2021-10-07 10:30:51.51
268,2020-10-13,00:00,24794,22856,20124,434,1504,2383842,2428760,2408636,1.029379284,2020-10-13 00:00:00.000,2021-10-07 10:30:51.51
267,2020-10-12,00:00,24703,22722,19192,433,1548,2371715,2415610,2396418,1.030830181,2020-10-12 00:00:00.000,2021-10-07 10:30:51.51
266,2020-10-11,00:00,24605,22686,19303,432,1487,2366575,2410483,2391180,1.028989871,2020-10-11 00:00:00.000,2021-10-07 10:30:51.51
265,2020-10-10,00:00,24547,22617,18982,430,1500,2361155,2404684,2385702,1.028921466,2020-10-10 00:00:00.000,2021-10-07 10:30:51.51
264,2020-10-09,00:00,24475,22562,20699,428,1485,2355059,2400233,2379534,1.028562735,2020-10-09 00:00:00.000,2021-10-07 10:30:51.51
263,2020-10-08,00:00,24421,22457,20978,427,1537,2343445,2388844,2367866,1.031350592,2020-10-08 00:00:00.000,2021-10-07 10:30:51.51
262,2020-10-07,00:00,24352,22326,22138,425,1601,2331583,2378073,2355935,1.033644816,2020-10-07 00:00:00.000,2021-10-07 10:30:51.51
261,2020-10-06,00:00,24238,22073,22737,422,1743,2318458,2365433,2342696,1.034619942,2020-10-06 00:00:00.000,2021-10-07 10:30:51.51
260,2020-10-05,00:00,24163,21878,22447,422,1863,2305768,2352378,2329931,1.037069338,2020-10-05 00:00:00.000,2021-10-07 10:30:51.51
259,2020-10-04,00:00,24090,21837,22116,421,1832,2300139,2346345,2324229,1.03647274,2020-10-04 00:00:00.000,2021-10-07 10:30:51.51
258,2020-10-03,00:00,24026,21779,21287,420,1827,2294546,2339859,2318572,1.036241273,2020-10-03 00:00:00.000,2021-10-07 10:30:51.51
257,2020-10-02,00:00,23951,21725,19995,416,1810,2289831,2333777,2313782,1.035145057,2020-10-02 00:00:00.000,2021-10-07 10:30:51.51
256,2020-10-01,00:00,23888,21658,20029,415,1815,2284518,2328435,2308406,1.034826629,2020-10-01 00:00:00.000,2021-10-07 10:30:51.51
255,2020-09-30,00:00,23811,21586,20596,413,1812,2278592,2322999,2302403,1.034180376,2020-09-30 00:00:00.000,2021-10-07 10:30:51.51
254,2020-09-29,00:00,23698,21462,20056,407,1829,2269290,2313044,2292988,1.033498649,2020-09-29 00:00:00.000,2021-10-07 10:30:51.51
253,2020-09-28,00:00,23660,21284,18587,406,1970,2259056,2301303,2282716,1.036484609,2020-09-28 00:00:00.000,2021-10-07 10:30:51.51
252,2020-09-27,00:00,23610,21240,18878,401,1969,2254029,2296517,2277639,1.036599742,2020-09-27 00:00:00.000,2021-10-07 10:30:51.51
251,2020-09-26,00:00,23515,21158,18508,399,1958,2248322,2290345,2271837,1.035065456,2020-09-26 00:00:00.000,2021-10-07 10:30:51.51
250,2020-09-25,00:00,23454,20971,19575,395,2088,2237247,2280276,2260701,1.037465813,2020-09-25 00:00:00.000,2021-10-07 10:30:51.51
249,2020-09-24,00:00,23340,20824,20782,393,2123,2224877,2268999,2248217,1.038156014,2020-09-24 00:00:00.000,2021-10-07 10:30:51.51
248,2020-09-23,00:00,23215,20643,20527,388,2184,2213157,2256899,2236372,1.038065223,2020-09-23 00:00:00.000,2021-10-07 10:30:51.51
247,2020-09-22,00:00,23105,20434,23222,388,2283,2198785,2245112,2221890,1.039880462,2020-09-22 00:00:00.000,2021-10-07 10:30:51.51
246,2020-09-21,00:00,23044,20239,22536,385,2420,2186009,2231589,2209053,1.043161934,2020-09-21 00:00:00.000,2021-10-07 10:30:51.51
245,2020-09-20,00:00,22974,20150,24274,383,2441,2179453,2226701,2202427,1.043121974,2020-09-20 00:00:00.000,2021-10-07 10:30:51.51
244,2020-09-19,00:00,22892,19962,24705,378,2552,2171565,2219162,2194457,1.043173778,2020-09-19 00:00:00.000,2021-10-07 10:30:51.51
243,2020-09-18,00:00,22782,19761,25403,377,2644,2158180,2206365,2180962,1.044584913,2020-09-18 00:00:00.000,2021-10-07 10:30:51.51
242,2020-09-17,00:00,22656,19533,25508,372,2751,2143728,2191892,2166384,1.045797975,2020-09-17 00:00:00.000,2021-10-07 10:30:51.51
241,2020-09-16,00:00,22503,19298,25842,367,2838,2130487,2178832,2152990,1.045197609,2020-09-16 00:00:00.000,2021-10-07 10:30:51.51
240,2020-09-15,00:00,22390,18870,27310,367,3153,2114878,2164578,2137268,1.047599084,2020-09-15 00:00:00.000,2021-10-07 10:30:51.51
239,2020-09-14,00:00,22284,18482,27476,363,3439,2101242,2151002,2123526,1.049386728,2020-09-14 00:00:00.000,2021-10-07 10:30:51.51
238,2020-09-13,00:00,22175,18221,27705,358,3596,2093390,2143270,2115565,1.048183346,2020-09-13 00:00:00.000,2021-10-07 10:30:51.51
237,2020-09-12,00:00,22054,18022,27826,355,3677,2085577,2135457,2107631,1.046388101,2020-09-12 00:00:00.000,2021-10-07 10:30:51.51
236,2020-09-11,00:00,21918,17609,29423,350,3959,2067870,2119211,2089788,1.048814521,2020-09-11 00:00:00.000,2021-10-07 10:30:51.51
235,2020-09-10,00:00,21742,17353,33018,346,4043,2044831,2099591,2066573,1.052079941,2020-09-10 00:00:00.000,2021-10-07 10:30:51.51
234,2020-09-09,00:00,21587,17016,36533,344,4227,2024114,2082234,2045701,1.0552373,2020-09-09 00:00:00.000,2021-10-07 10:30:51.51
233,2020-09-08,00:00,21431,16631,43370,341,4459,2001277,2066078,2022708,1.059520208,2020-09-08 00:00:00.000,2021-10-07 10:30:51.51
232,2020-09-07,00:00,21295,16288,47109,336,4671,1982893,2051297,2004188,1.062525072,2020-09-07 00:00:00.000,2021-10-07 10:30:51.51
231,2020-09-06,00:00,21176,16118,49621,334,4724,1975138,2045935,1996314,1.060754971,2020-09-06 00:00:00.000,2021-10-07 10:30:51.51
230,2020-09-05,00:00,21009,15983,52077,333,4693,1963959,2037045,1984968,1.058404972,2020-09-05 00:00:00.000,2021-10-07 10:30:51.51
229,2020-09-04,00:00,20841,15764,52266,331,4746,1945799,2018906,1966640,1.059726234,2020-09-04 00:00:00.000,2021-10-07 10:30:51.51
228,2020-09-03,00:00,20643,15522,55524,329,4792,1924385,2000552,1945028,1.061321482,2020-09-03 00:00:00.000,2021-10-07 10:30:51.51
227,2020-09-02,00:00,20448,15351,56748,326,4771,1903099,1980295,1923547,1.063036151,2020-09-02 00:00:00.000,2021-10-07 10:30:51.51
226,2020-09-01,00:00,20181,15192,56743,324,4665,1882156,1959080,1902337,1.060853045,2020-09-01 00:00:00.000,2021-10-07 10:30:51.51
225,2020-08-31,00:00,19946,14966,57876,324,4656,1859867,1937689,1879813,1.061062989,2020-08-31 00:00:00.000,2021-10-07 10:30:51.51
224,2020-08-30,00:00,19698,14898,58021,323,4477,1846451,1924170,1866149,1.055542725,2020-08-30 00:00:00.000,2021-10-07 10:30:51.51
223,2020-08-29,00:00,19399,14760,54046,321,4318,1835884,1909329,1855283,1.045608675,2020-08-29 00:00:00.000,2021-10-07 10:30:51.51
222,2020-08-28,00:00,19076,14547,50711,316,4213,1817930,1887717,1837006,1.038428835,2020-08-28 00:00:00.000,2021-10-07 10:30:51.51
221,2020-08-27,00:00,18705,14457,52041,313,3935,1798833,1869579,1817538,1.029139418,2020-08-27 00:00:00.000,2021-10-07 10:30:51.51
220,2020-08-26,00:00,18264,14364,52795,312,3588,1778447,1849506,1796711,1.016524082,2020-08-26 00:00:00.000,2021-10-07 10:30:51.51
219,2020-08-25,00:00,17944,14283,50362,310,3351,1757531,1825837,1775475,1.010659119,2020-08-25 00:00:00.000,2021-10-07 10:30:51.51
218,2020-08-24,00:00,17664,14216,47995,309,3139,1738763,1804422,1756427,1.005678004,2020-08-24 00:00:00.000,2021-10-07 10:30:51.51
217,2020-08-23,00:00,17398,14197,47564,309,2892,1726224,1791186,1743622,0.997808011,2020-08-23 00:00:00.000,2021-10-07 10:30:51.51
216,2020-08-22,00:00,17002,14166,42427,309,2527,1716371,1775800,1733373,0.980862169,2020-08-22 00:00:00.000,2021-10-07 10:30:51.51
215,2020-08-21,00:00,16670,14118,38045,309,2243,1699408,1754123,1716078,0.971401067,2020-08-21 00:00:00.000,2021-10-07 10:30:51.51
214,2020-08-20,00:00,16346,14061,34998,307,1978,1682739,1734083,1699085,0.96204722,2020-08-20 00:00:00.000,2021-10-07 10:30:51.51
213,2020-08-19,00:00,16058,14004,31022,306,1748,1667984,1715064,1684042,0.953539164,2020-08-19 00:00:00.000,2021-10-07 10:30:51.51
212,2020-08-18,00:00,15761,13932,25219,306,1523,1656062,1697042,1671823,0.942743341,2020-08-18 00:00:00.000,2021-10-07 10:30:51.51
211,2020-08-17,00:00,15515,13915,22964,305,1295,1649991,1688470,1665506,0.931548731,2020-08-17 00:00:00.000,2021-10-07 10:30:51.51
210,2020-08-16,00:00,15318,13908,22005,305,1105,1644464,1681787,1659782,0.922892283,2020-08-16 00:00:00.000,2021-10-07 10:30:51.51
209,2020-08-15,00:00,15039,13899,21618,305,835,1638639,1675296,1653678,0.909427349,2020-08-15 00:00:00.000,2021-10-07 10:30:51.51
208,2020-08-14,00:00,14873,13861,20132,305,707,1630079,1665084,1644952,0.904160121,2020-08-14 00:00:00.000,2021-10-07 10:30:51.51
207,2020-08-13,00:00,14770,13814,17798,305,651,1622330,1654898,1637100,0.902205119,2020-08-13 00:00:00.000,2021-10-07 10:30:51.51
206,2020-08-12,00:00,14714,13783,17375,305,626,1614563,1646652,1629277,0.903099964,2020-08-12 00:00:00.000,2021-10-07 10:30:51.51
205,2020-08-11,00:00,14660,13725,17489,305,630,1605695,1637844,1620355,0.904740011,2020-08-11 00:00:00.000,2021-10-07 10:30:51.51
204,2020-08-10,00:00,14626,13654,16396,305,667,1597281,1628303,1611907,0.907372448,2020-08-10 00:00:00.000,2021-10-07 10:30:51.51
203,2020-08-09,00:00,14598,13638,16803,305,655,1593249,1624650,1607847,0.907922209,2020-08-09 00:00:00.000,2021-10-07 10:30:51.51
202,2020-08-08,00:00,14562,13625,16105,304,633,1589847,1620514,1604409,0.907623929,2020-08-08 00:00:00.000,2021-10-07 10:30:51.51
201,2020-08-07,00:00,14519,13540,17068,303,676,1582065,1613652,1596584,0.909379024,2020-08-07 00:00:00.000,2021-10-07 10:30:51.51
200,2020-08-06,00:00,14499,13496,18031,302,701,1573957,1606487,1588456,0.912773158,2020-08-06 00:00:00.000,2021-10-07 10:30:51.51
199,2020-08-05,00:00,14456,13402,18490,302,752,1565241,1598187,1579697,0.915112202,2020-08-05 00:00:00.000,2021-10-07 10:30:51.51
198,2020-08-04,00:00,14423,13346,18724,301,776,1556633,1589780,1571056,0.918044933,2020-08-04 00:00:00.000,2021-10-07 10:30:51.51
197,2020-08-03,00:00,14389,13275,17401,301,813,1547967,1579757,1562356,0.920980878,2020-08-03 00:00:00.000,2021-10-07 10:30:51.51
196,2020-08-02,00:00,14366,13254,17768,301,811,1544112,1576246,1558478,0.921796779,2020-08-02 00:00:00.000,2021-10-07 10:30:51.51
195,2020-08-01,00:00,14336,13228,18278,301,807,1539216,1571830,1553552,0.922788552,2020-08-01 00:00:00.000,2021-10-07 10:30:51.51
194,2020-07-31,00:00,14305,13179,18330,301,825,1531161,1563796,1545466,0.925610787,2020-07-31 00:00:00.000,2021-10-07 10:30:51.51
193,2020-07-30,00:00,14269,13128,19018,300,841,1522928,1556215,1537197,0.928247973,2020-07-30 00:00:00.000,2021-10-07 10:30:51.51
192,2020-07-29,00:00,14251,13066,19326,300,885,1513730,1547307,1527981,0.932668665,2020-07-29 00:00:00.000,2021-10-07 10:30:51.51
191,2020-07-28,00:00,14203,13002,20444,300,901,1503057,1537704,1517260,0.93609533,2020-07-28 00:00:00.000,2021-10-07 10:30:51.51
190,2020-07-27,00:00,14175,12899,18770,299,977,1494029,1526974,1508204,0.939859595,2020-07-27 00:00:00.000,2021-10-07 10:30:51.51
189,2020-07-26,00:00,14150,12884,19214,298,968,1489562,1522926,1503712,0.94100466,2020-07-26 00:00:00.000,2021-10-07 10:30:51.51
188,2020-07-25,00:00,14092,12860,19681,298,934,1484861,1518634,1498953,0.940122872,2020-07-25 00:00:00.000,2021-10-07 10:30:51.51
187,2020-07-24,00:00,13979,12811,20559,298,870,1475789,1510327,1489768,0.938334022,2020-07-24 00:00:00.000,2021-10-07 10:30:51.51
186,2020-07-23,00:00,13938,12752,21418,297,889,1465498,1500854,1479436,0.942115779,2020-07-23 00:00:00.000,2021-10-07 10:30:51.51
185,2020-07-22,00:00,13879,12692,21751,297,890,1456441,1492071,1470320,0.943944175,2020-07-22 00:00:00.000,2021-10-07 10:30:51.51
184,2020-07-21,00:00,13816,12638,23864,296,882,1444710,1482390,1458526,0.947257711,2020-07-21 00:00:00.000,2021-10-07 10:30:51.51
183,2020-07-20,00:00,13771,12567,21302,296,908,1435120,1470193,1448891,0.950451069,2020-07-20 00:00:00.000,2021-10-07 10:30:51.51
182,2020-07-19,00:00,13745,12549,21953,295,901,1429601,1465299,1443346,0.952301111,2020-07-19 00:00:00.000,2021-10-07 10:30:51.51
181,2020-07-18,00:00,13711,12513,22923,294,904,1423570,1460204,1437281,0.953954028,2020-07-18 00:00:00.000,2021-10-07 10:30:51.51
180,2020-07-17,00:00,13672,12455,23110,293,924,1414235,1451017,1427907,0.957485326,2020-07-17 00:00:00.000,2021-10-07 10:30:51.51
179,2020-07-16,00:00,13612,12393,23404,291,928,1404332,1441348,1417944,0.959981494,2020-07-16 00:00:00.000,2021-10-07 10:30:51.51
178,2020-07-15,00:00,13551,12344,23297,289,918,1394468,1431316,1408019,0.96241599,2020-07-15 00:00:00.000,2021-10-07 10:30:51.51
177,2020-07-14,00:00,13512,12275,24289,289,948,1382815,1420616,1396327,0.967681639,2020-07-14 00:00:00.000,2021-10-07 10:30:51.51
176,2020-07-13,00:00,13479,12198,21845,289,992,1372988,1408312,1386467,0.972183254,2020-07-13 00:00:00.000,2021-10-07 10:30:51.51
175,2020-07-12,00:00,13417,12173,21830,289,955,1366897,1402144,1380314,0.972025206,2020-07-12 00:00:00.000,2021-10-07 10:30:51.51
174,2020-07-11,00:00,13373,12139,22950,288,946,1360618,1396941,1373991,0.973296041,2020-07-11 00:00:00.000,2021-10-07 10:30:51.51
173,2020-07-10,00:00,13338,12061,23527,288,989,1348025,1384890,1361363,0.97975338,2020-07-10 00:00:00.000,2021-10-07 10:30:51.51
172,2020-07-09,00:00,13293,12016,23912,287,990,1334566,1371771,1347859,0.986230756,2020-07-09 00:00:00.000,2021-10-07 10:30:51.51
171,2020-07-08,00:00,13243,11967,24012,285,991,1322479,1359734,1335722,0.991448819,2020-07-08 00:00:00.000,2021-10-07 10:30:51.51
170,2020-07-07,00:00,13181,11911,23675,285,985,1309338,1346194,1322519,0.996658649,2020-07-07 00:00:00.000,2021-10-07 10:30:51.51
169,2020-07-06,00:00,13137,11845,21292,284,1008,1297367,1331796,1310504,1.002438756,2020-07-06 00:00:00.000,2021-10-07 10:30:51.51
168,2020-07-05,00:00,13089,11828,21649,283,978,1291317,1326055,1304406,1.003445246,2020-07-05 00:00:00.000,2021-10-07 10:30:51.51
167,2020-07-04,00:00,13028,11808,22321,283,937,1284172,1319521,1297200,1.00431699,2020-07-04 00:00:00.000,2021-10-07 10:30:51.51
166,2020-07-03,00:00,12965,11755,21560,282,928,1273234,1307759,1286199,1.00800887,2020-07-03 00:00:00.000,2021-10-07 10:30:51.51
165,2020-07-02,00:00,12904,11681,19782,282,941,1263276,1295962,1276180,1.011142629,2020-07-02 00:00:00.000,2021-10-07 10:30:51.51
164,2020-07-01,00:00,12850,11611,19526,282,957,1252855,1285231,1265705,1.015244468,2020-07-01 00:00:00.000,2021-10-07 10:30:51.51
163,2020-06-30,00:00,12799,11533,20809,282,984,1240157,1273765,1252956,1.021504347,2020-06-30 00:00:00.000,2021-10-07 10:30:51.51
162,2020-06-29,00:00,12757,11425,18499,282,1050,1228698,1259954,1241455,1.027584568,2020-06-29 00:00:00.000,2021-10-07 10:30:51.51
161,2020-06-28,00:00,12715,11360,19005,282,1073,1219975,1251695,1232690,1.03148399,2020-06-28 00:00:00.000,2021-10-07 10:30:51.51
160,2020-06-27,00:00,12653,11314,19866,282,1057,1211261,1243780,1223914,1.033814467,2020-06-27 00:00:00.000,2021-10-07 10:30:51.51
159,2020-06-26,00:00,12602,11171,18828,282,1149,1200885,1232315,1213487,1.03849485,2020-06-26 00:00:00.000,2021-10-07 10:30:51.51
158,2020-06-25,00:00,12563,10973,18900,282,1308,1189015,1220478,1201578,1.045541779,2020-06-25 00:00:00.000,2021-10-07 10:30:51.51
157,2020-06-24,00:00,12535,10929,20245,281,1325,1175817,1208597,1188352,1.05482214,2020-06-24 00:00:00.000,2021-10-07 10:30:51.51
156,2020-06-23,00:00,12484,10907,22278,281,1296,1161250,1196012,1173734,1.063614073,2020-06-23 00:00:00.000,2021-10-07 10:30:51.51
155,2020-06-22,00:00,12438,10880,19403,280,1278,1150225,1182066,1162663,1.069785484,2020-06-22 00:00:00.000,2021-10-07 10:30:51.51
154,2020-06-21,00:00,12421,10867,20071,280,1274,1143971,1176463,1156392,1.074116736,2020-06-21 00:00:00.000,2021-10-07 10:30:51.51
153,2020-06-20,00:00,12373,10860,21470,280,1233,1137058,1170901,1149431,1.07644565,2020-06-20 00:00:00.000,2021-10-07 10:30:51.51
152,2020-06-19,00:00,12306,10835,21190,280,1191,1124567,1158063,1136873,1.082442806,2020-06-19 00:00:00.000,2021-10-07 10:30:51.51
151,2020-06-18,00:00,12257,10800,21714,280,1177,1111741,1145712,1123998,1.090482367,2020-06-18 00:00:00.000,2021-10-07 10:30:51.51
150,2020-06-17,00:00,12198,10774,21489,279,1145,1099136,1132823,1111334,1.097599821,2020-06-17 00:00:00.000,2021-10-07 10:30:51.51
149,2020-06-16,00:00,12155,10760,22632,278,1117,1084980,1119767,1097135,1.107885538,2020-06-16 00:00:00.000,2021-10-07 10:30:51.51
148,2020-06-15,00:00,12121,10730,20793,277,1114,1072805,1105719,1084926,1.117219055,2020-06-15 00:00:00.000,2021-10-07 10:30:51.51
147,2020-06-14,00:00,12084,10718,21356,277,1089,1066887,1100327,1078971,1.119955958,2020-06-14 00:00:00.000,2021-10-07 10:30:51.51
146,2020-06-13,00:00,12050,10691,23352,277,1082,1059302,1094704,1071352,1.124747049,2020-06-13 00:00:00.000,2021-10-07 10:30:51.51
145,2020-06-12,00:00,12002,10668,24244,277,1057,1045240,1081486,1057242,1.135217859,2020-06-12 00:00:00.000,2021-10-07 10:30:51.51
144,2020-06-11,00:00,11946,10653,25494,276,1017,1029448,1066888,1041394,1.147116269,2020-06-11 00:00:00.000,2021-10-07 10:30:51.51
143,2020-06-10,00:00,11901,10611,26223,276,1014,1013848,1051972,1025749,1.160225357,2020-06-10 00:00:00.000,2021-10-07 10:30:51.51
142,2020-06-09,00:00,11851,10590,27459,274,987,996687,1035997,1008538,1.175067276,2020-06-09 00:00:00.000,2021-10-07 10:30:51.51
141,2020-06-08,00:00,11813,10563,24374,273,977,982027,1018214,993840,1.188621911,2020-06-08 00:00:00.000,2021-10-07 10:30:51.51
140,2020-06-07,00:00,11776,10552,26481,273,951,974512,1012769,986288,1.193971741,2020-06-07 00:00:00.000,2021-10-07 10:30:51.51
139,2020-06-06,00:00,11719,10531,27954,273,915,965632,1005305,977351,1.199057452,2020-06-06 00:00:00.000,2021-10-07 10:30:51.51
138,2020-06-05,00:00,11668,10505,28766,273,890,950526,990960,962194,1.212645267,2020-06-05 00:00:00.000,2021-10-07 10:30:51.51
137,2020-06-04,00:00,11629,10498,28199,273,858,934030,973858,945659,1.229724457,2020-06-04 00:00:00.000,2021-10-07 10:30:51.51
136,2020-06-03,00:00,11590,10466,27865,273,851,917397,956852,928987,1.247595499,2020-06-03 00:00:00.000,2021-10-07 10:30:51.51
135,2020-06-02,00:00,11541,10445,28922,272,824,899388,939851,910929,1.266948357,2020-06-02 00:00:00.000,2021-10-07 10:30:51.51
134,2020-06-01,00:00,11503,10421,24058,271,811,885830,921391,897333,1.281909837,2020-06-01 00:00:00.000,2021-10-07 10:30:51.51
133,2020-05-31,00:00,11468,10404,23294,270,794,876060,910822,887528,1.292128248,2020-05-31 00:00:00.000,2021-10-07 10:30:51.51
132,2020-05-30,00:00,11441,10397,26298,269,775,865162,902901,876603,1.305151819,2020-05-30 00:00:00.000,2021-10-07 10:30:51.51
131,2020-05-29,00:00,11402,10362,24557,269,771,849161,885120,860563,1.324946576,2020-05-29 00:00:00.000,2021-10-07 10:30:51.51
130,2020-05-28,00:00,11344,10339,22370,269,736,834952,868666,846296,1.340429353,2020-05-28 00:00:00.000,2021-10-07 10:30:51.51
129,2020-05-27,00:00,11265,10294,21061,269,702,820550,852876,831815,1.354267475,2020-05-27 00:00:00.000,2021-10-07 10:30:51.51
128,2020-05-26,00:00,11225,10273,22044,269,683,806206,839475,817431,1.373204589,2020-05-26 00:00:00.000,2021-10-07 10:30:51.51
127,2020-05-25,00:00,11206,10224,19089,267,715,796142,826437,807348,1.388001209,2020-05-25 00:00:00.000,2021-10-07 10:30:51.51
126,2020-05-24,00:00,11190,10211,20333,266,713,788766,820289,799956,1.398826935,2020-05-24 00:00:00.000,2021-10-07 10:30:51.51
125,2020-05-23,00:00,11165,10192,21569,266,707,781686,814420,792851,1.408209109,2020-05-23 00:00:00.000,2021-10-07 10:30:51.51
124,2020-05-22,00:00,11142,10159,20286,264,719,770990,802418,782132,1.42456772,2020-05-22 00:00:00.000,2021-10-07 10:30:51.51
123,2020-05-21,00:00,11122,10132,18089,264,726,759473,788684,770595,1.443300307,2020-05-21 00:00:00.000,2021-10-07 10:30:51.51
122,2020-05-20,00:00,11110,10061,16351,263,786,748972,776433,760082,1.461684397,2020-05-20 00:00:00.000,2021-10-07 10:30:51.51
121,2020-05-19,00:00,11078,9930,16925,263,885,737571,765574,748649,1.479732158,2020-05-19 00:00:00.000,2021-10-07 10:30:51.51
120,2020-05-18,00:00,11065,9883,16093,263,919,726053,753211,737118,1.501116511,2020-05-18 00:00:00.000,2021-10-07 10:30:51.51
119,2020-05-17,00:00,11050,9860,17660,262,928,718943,747653,729993,1.513713145,2020-05-17 00:00:00.000,2021-10-07 10:30:51.51
118,2020-05-16,00:00,11037,9811,18343,262,964,711265,740645,722302,1.528031211,2020-05-16 00:00:00.000,2021-10-07 10:30:51.51
117,2020-05-15,00:00,11018,9774,19875,260,984,695854,726747,706872,1.558698039,2020-05-15 00:00:00.000,2021-10-07 10:30:51.51
115,2020-05-13,00:00,10962,9629,19579,259,1074,665379,695920,676341,1.62078005,2020-05-13 00:00:00.000,2021-10-07 10:30:51.51
114,2020-05-12,00:00,10936,9567,16330,258,1111,653624,680890,664560,1.645600096,2020-05-12 00:00:00.000,2021-10-07 10:30:51.51
113,2020-05-11,00:00,10909,9527,10922,256,1126,646661,668492,657570,1.658986876,2020-05-11 00:00:00.000,2021-10-07 10:30:51.51
112,2020-05-10,00:00,10874,9493,10128,256,1125,642884,663886,653758,1.663306606,2020-05-10 00:00:00.000,2021-10-07 10:30:51.51
111,2020-05-09,00:00,10840,9444,9153,256,1140,640037,660030,650877,1.665445238,2020-05-09 00:00:00.000,2021-10-07 10:30:51.51
110,2020-05-08,00:00,10822,9356,8867,256,1210,635174,654863,645996,1.675242571,2020-05-08 00:00:00.000,2021-10-07 10:30:51.51
109,2020-05-07,00:00,10810,9286,8429,256,1268,630149,649388,640959,1.686535332,2020-05-07 00:00:00.000,2021-10-07 10:30:51.51
108,2020-05-06,00:00,10806,9195,8009,255,1356,624280,643095,635086,1.701501844,2020-05-06 00:00:00.000,2021-10-07 10:30:51.51
107,2020-05-05,00:00,10804,9144,8858,254,1406,620575,640237,631379,1.711175063,2020-05-05 00:00:00.000,2021-10-07 10:30:51.51
106,2020-05-04,00:00,10801,9073,8176,252,1476,614944,633921,625745,1.726102486,2020-05-04 00:00:00.000,2021-10-07 10:30:51.51
105,2020-05-03,00:00,10793,9032,8588,250,1511,611592,630973,622385,1.734135623,2020-05-03 00:00:00.000,2021-10-07 10:30:51.51
104,2020-05-02,00:00,10780,8968,8496,250,1562,608286,627562,619066,1.741332911,2020-05-02 00:00:00.000,2021-10-07 10:30:51.51
103,2020-05-01,00:00,10774,8910,8685,248,1616,603610,623069,614384,1.753626397,2020-05-01 00:00:00.000,2021-10-07 10:30:51.51
102,2020-04-30,00:00,10765,8876,8634,247,1642,600482,619881,611247,1.761153838,2020-04-30 00:00:00.000,2021-10-07 10:30:51.51
101,2020-04-29,00:00,10761,8736,8307,246,1779,595129,614197,605890,1.776064962,2020-04-29 00:00:00.000,2021-10-07 10:30:51.51
100,2020-04-28,00:00,10752,8673,9203,244,1835,588559,608514,599311,1.794060179,2020-04-28 00:00:00.000,2021-10-07 10:30:51.51
99,2020-04-27,00:00,10738,8573,8895,243,1922,582027,601660,592765,1.811510464,2020-04-27 00:00:00.000,2021-10-07 10:30:51.51
98,2020-04-26,00:00,10728,8525,8999,242,1961,578558,598285,589286,1.820508208,2020-04-26 00:00:00.000,2021-10-07 10:30:51.51
97,2020-04-25,00:00,10718,8436,9259,240,2042,575184,595161,585902,1.829316166,2020-04-25 00:00:00.000,2021-10-07 10:30:51.51
96,2020-04-24,00:00,10708,8284,9600,240,2184,569212,589520,579920,1.846461581,2020-04-24 00:00:00.000,2021-10-07 10:30:51.51
95,2020-04-23,00:00,10702,8192,10139,240,2270,563130,583971,573832,1.865005786,2020-04-23 00:00:00.000,2021-10-07 10:30:51.51
94,2020-04-22,00:00,10694,8047,12121,238,2409,555144,577959,565838,1.88994023,2020-04-22 00:00:00.000,2021-10-07 10:30:51.51
93,2020-04-21,00:00,10683,7976,12721,237,2470,547610,571014,558293,1.913511364,2020-04-21 00:00:00.000,2021-10-07 10:30:51.51
92,2020-04-20,00:00,10674,7873,11981,236,2565,540380,563035,551054,1.937015247,2020-04-20 00:00:00.000,2021-10-07 10:30:51.51
91,2020-04-19,00:00,10661,7807,12243,234,2620,536205,559109,546866,1.949472083,2020-04-19 00:00:00.000,2021-10-07 10:30:51.51
90,2020-04-18,00:00,10653,7706,13550,232,2715,530631,554834,541284,1.968098078,2020-04-18 00:00:00.000,2021-10-07 10:30:51.51
89,2020-04-17,00:00,10635,7598,14186,230,2807,521642,546463,532277,1.998019828,2020-04-17 00:00:00.000,2021-10-07 10:30:51.51
88,2020-04-16,00:00,10613,7516,14268,229,2868,513894,538775,524507,2.023423901,2020-04-16 00:00:00.000,2021-10-07 10:30:51.51
87,2020-04-15,00:00,10591,7377,15026,225,2989,508935,534552,519526,2.038589022,2020-04-15 00:00:00.000,2021-10-07 10:30:51.51
86,2020-04-14,00:00,10564,7291,14651,222,3051,502223,527438,512787,2.060114628,2020-04-14 00:00:00.000,2021-10-07 10:30:51.51
85,2020-04-13,00:00,10537,7198,13391,217,3122,494815,518743,505352,2.08508129,2020-04-13 00:00:00.000,2021-10-07 10:30:51.51
84,2020-04-12,00:00,10512,7122,13788,214,3176,490321,514621,500833,2.098903227,2020-04-12 00:00:00.000,2021-10-07 10:30:51.51
83,2020-04-11,00:00,10480,6994,14070,211,3275,485929,510479,496409,2.111162368,2020-04-11 00:00:00.000,2021-10-07 10:30:51.51
82,2020-04-10,00:00,10450,6871,15298,208,3371,477303,503051,487753,2.142477853,2020-04-10 00:00:00.000,2021-10-07 10:30:51.51
81,2020-04-09,00:00,10423,6715,15509,204,3504,468779,494711,479202,2.175074395,2020-04-09 00:00:00.000,2021-10-07 10:30:51.51
80,2020-04-08,00:00,10384,6530,17858,200,3654,457761,486003,468145,2.218116182,2020-04-08 00:00:00.000,2021-10-07 10:30:51.51
79,2020-04-07,00:00,10331,6451,20650,192,3688,446323,477304,456654,2.262325524,2020-04-07 00:00:00.000,2021-10-07 10:30:51.51
78,2020-04-06,00:00,10284,6359,19295,186,3739,437225,466804,447509,2.298054341,2020-04-06 00:00:00.000,2021-10-07 10:30:51.51
77,2020-04-05,00:00,10237,6227,19571,183,3827,431425,461233,441662,2.317835811,2020-04-05 00:00:00.000,2021-10-07 10:30:51.51
76,2020-04-04,00:00,10156,6084,20144,177,3895,424732,455032,434888,2.33531392,2020-04-04 00:00:00.000,2021-10-07 10:30:51.51
75,2020-04-03,00:00,10062,5789,18908,174,4099,414303,443273,424365,2.371072072,2020-04-03 00:00:00.000,2021-10-07 10:30:51.51
74,2020-04-02,00:00,9976,5609,17885,169,4198,403882,431743,413858,2.410488622,2020-04-02 00:00:00.000,2021-10-07 10:30:51.51
73,2020-04-01,00:00,9887,5361,16585,165,4361,395075,421547,404962,2.441463644,2020-04-01 00:00:00.000,2021-10-07 10:30:51.51
72,2020-03-31,00:00,9786,5206,16892,162,4418,383886,410564,393672,2.485825764,2020-03-31 00:00:00.000,2021-10-07 10:30:51.51
71,2020-03-30,00:00,9661,5043,13531,158,4460,375710,398902,385371,2.506934876,2020-03-30 00:00:00.000,2021-10-07 10:30:51.51
70,2020-03-29,00:00,9583,4857,15028,152,4574,369530,394141,379113,2.527742388,2020-03-29 00:00:00.000,2021-10-07 10:30:51.51
69,2020-03-28,00:00,9478,4641,16564,144,4693,361883,387925,371361,2.552233541,2020-03-28 00:00:00.000,2021-10-07 10:30:51.51
68,2020-03-27,00:00,9332,4367,15219,139,4826,352410,376961,361742,2.579739151,2020-03-27 00:00:00.000,2021-10-07 10:30:51.51
67,2020-03-26,00:00,9241,4001,14369,131,5109,341332,364942,350573,2.635970254,2020-03-26 00:00:00.000,2021-10-07 10:30:51.51
66,2020-03-25,00:00,9137,3606,14278,126,5405,334481,357896,343618,2.659057442,2020-03-25 00:00:00.000,2021-10-07 10:30:51.51
65,2020-03-24,00:00,9037,3396,15440,120,5521,324105,348582,333142,2.712657065,2020-03-24 00:00:00.000,2021-10-07 10:30:51.51
64,2020-03-23,00:00,8961,3065,13628,111,5785,315447,338036,324408,2.762262336,2020-03-23 00:00:00.000,2021-10-07 10:30:51.51
63,2020-03-22,00:00,8897,2817,14540,104,5976,308343,331780,317240,2.804501324,2020-03-22 00:00:00.000,2021-10-07 10:30:51.51
62,2020-03-21,00:00,8799,2536,15704,102,6161,303006,327509,311805,2.82195603,2020-03-21 00:00:00.000,2021-10-07 10:30:51.51
61,2020-03-20,00:00,8652,2173,15525,94,6385,292487,316664,301139,2.873091828,2020-03-20 00:00:00.000,2021-10-07 10:30:51.51
60,2020-03-19,00:00,8565,1896,15904,91,6578,282555,307024,291120,2.942085738,2020-03-19 00:00:00.000,2021-10-07 10:30:51.51
59,2020-03-18,00:00,8413,1498,16346,84,6831,270888,295647,279301,3.012162506,2020-03-18 00:00:00.000,2021-10-07 10:30:51.51
58,2020-03-17,00:00,8320,1362,17291,81,6877,261105,286716,269425,3.088057901,2020-03-17 00:00:00.000,2021-10-07 10:30:51.51
57,2020-03-16,00:00,8236,1106,14971,75,7055,251297,274504,259533,3.173392208,2020-03-16 00:00:00.000,2021-10-07 10:30:51.51
56,2020-03-15,00:00,8162,807,16272,75,7280,243778,268212,251940,3.239660237,2020-03-15 00:00:00.000,2021-10-07 10:30:51.51
55,2020-03-14,00:00,8086,690,17634,72,7324,235615,261335,243701,3.318000336,2020-03-14 00:00:00.000,2021-10-07 10:30:51.51
54,2020-03-13,00:00,7979,490,17940,67,7422,222728,248647,230707,3.458499309,2020-03-13 00:00:00.000,2021-10-07 10:30:51.51
53,2020-03-12,00:00,7869,318,17727,66,7485,209402,234998,217271,3.621744273,2020-03-12 00:00:00.000,2021-10-07 10:30:51.51
52,2020-03-11,00:00,7755,272,18540,60,7423,196100,222395,203855,3.804174536,2020-03-11 00:00:00.000,2021-10-07 10:30:51.51
51,2020-03-10,00:00,7513,232,18452,54,7227,184179,210144,191692,3.919308057,2020-03-10 00:00:00.000,2021-10-07 10:30:51.51
50,2020-03-09,00:00,7382,159,17458,51,7172,171778,196618,179160,4.120339361,2020-03-09 00:00:00.000,2021-10-07 10:30:51.51
49,2020-03-08,00:00,7134,126,19376,50,6958,162008,188518,169142,4.21775786,2020-03-08 00:00:00.000,2021-10-07 10:30:51.51
48,2020-03-07,00:00,6767,115,19620,44,6608,151802,178189,158569,4.267542836,2020-03-07 00:00:00.000,2021-10-07 10:30:51.51
47,2020-03-06,00:00,6284,106,21832,42,6136,136624,164740,142908,4.397234584,2020-03-06 00:00:00.000,2021-10-07 10:30:51.51
46,2020-03-05,00:00,5766,86,21810,35,5645,118965,146541,124731,4.622748154,2020-03-05 00:00:00.000,2021-10-07 10:30:51.51
45,2020-03-04,00:00,5328,40,28414,32,5256,102965,136707,108293,4.919985595,2020-03-04 00:00:00.000,2021-10-07 10:30:51.51
44,2020-03-03,00:00,4812,34,35555,28,4750,85484,125851,90296,5.329139718,2020-03-03 00:00:00.000,2021-10-07 10:30:51.51
43,2020-03-02,00:00,4212,30,33799,23,4159,71580,109591,75792,5.557314756,2020-03-02 00:00:00.000,2021-10-07 10:30:51.51
42,2020-03-01,00:00,3526,28,33360,17,3481,60099,96985,63625,5.541846758,2020-03-01 00:00:00.000,2021-10-07 10:30:51.51
41,2020-02-29,00:00,2931,26,35182,16,2889,47580,85693,50511,5.802696442,2020-02-29 00:00:00.000,2021-10-07 10:30:51.51
40,2020-02-28,00:00,2022,25,30237,13,1984,38681,70940,40703,4.967692799,2020-02-28 00:00:00.000,2021-10-07 10:30:51.51
39,2020-02-27,00:00,1595,23,25568,12,1560,30827,57990,32422,4.919499106,2020-02-27 00:00:00.000,2021-10-07 10:30:51.51
38,2020-02-26,00:00,1146,21,20716,11,1114,24265,46127,25411,4.509857936,2020-02-26 00:00:00.000,2021-10-07 10:30:51.51
37,2020-02-25,00:00,893,21,13880,8,864,21943,36716,22836,3.910492205,2020-02-25 00:00:00.000,2021-10-07 10:30:51.51
36,2020-02-24,16:00,763,17,11631,7,739,16221,28615,16984,4.492463495,2020-02-24 16:00:00.000,2021-10-07 10:30:51.51
35,2020-02-23,16:00,556,17,8057,3,536,14020,22633,14576,3.814489572,2020-02-23 16:00:00.000,2021-10-07 10:30:51.51
34,2020-02-22,16:00,346,17,6037,3,326,13238,19621,13584,2.547114252,2020-02-22 16:00:00.000,2021-10-07 10:30:51.51
33,2020-02-21,16:00,156,16,3180,1,139,11480,14816,11636,1.340666896,2020-02-21 16:00:00.000,2021-10-07 10:30:51.51
32,2020-02-20,16:00,82,16,1860,1,65,10219,12161,10301,0.796039219,2020-02-20 16:00:00.000,2021-10-07 10:30:51.51
31,2020-02-19,16:00,66,12,1149,0,54,9196,10411,9262,0.712589074,2020-02-19 16:00:00.000,2021-10-07 10:30:51.51
30,2020-02-18,16:00,32,10,818,0,22,8415,9265,8447,0.378832722,2020-02-18 16:00:00.000,2021-10-07 10:30:51.51
29,2020-02-17,16:00,30,9,708,0,21,7433,8171,7463,0.401983117,2020-02-17 16:00:00.000,2021-10-07 10:30:51.51
28,2020-02-16,16:00,30,9,485,0,21,7404,7919,7434,0.403551251,2020-02-16 16:00:00.000,2021-10-07 10:30:51.51
27,2020-02-15,16:00,28,7,558,0,21,6933,7519,6961,0.402241057,2020-02-15 16:00:00.000,2021-10-07 10:30:51.51
26,2020-02-14,16:00,28,7,535,0,21,6291,6854,6319,0.443108087,2020-02-14 16:00:00.000,2021-10-07 10:30:51.51
25,2020-02-13,16:00,28,7,562,0,21,5207,5797,5235,0.534861509,2020-02-13 16:00:00.000,2021-10-07 10:30:51.51
24,2020-02-12,16:00,28,4,785,0,24,4261,5074,4289,0.652832828,2020-02-12 16:00:00.000,2021-10-07 10:30:51.51
23,2020-02-11,16:00,28,4,762,0,24,2839,3629,2867,0.976630624,2020-02-11 16:00:00.000,2021-10-07 10:30:51.51
22,2020-02-10,16:00,28,3,531,0,25,2217,2776,2245,1.247216036,2020-02-10 16:00:00.000,2021-10-07 10:30:51.51
21,2020-02-09,16:00,27,2,888,0,25,1425,2340,1452,1.859504132,2020-02-09 16:00:00.000,2021-10-07 10:30:51.51
20,2020-02-08,16:00,24,2,620,0,22,1057,1701,1081,2.220166512,2020-02-08 16:00:00.000,2021-10-07 10:30:51.51
19,2020-02-07,16:00,24,2,327,0,22,779,1130,803,2.98879203,2020-02-07 16:00:00.000,2021-10-07 10:30:51.51
18,2020-02-06,09:00,24,0,169,0,24,692,885,716,3.351955307,2020-02-06 09:00:00.000,2021-10-07 10:30:51.51
17,2020-02-05,19:00,21,0,40,0,21,653,714,674,3.115727003,2020-02-05 19:00:00.000,2021-10-07 10:30:51.51
16,2020-02-04,00:00,16,0,0,0,16,591,607,607,2.635914333,2020-02-04 00:00:00.000,2021-10-07 10:30:51.51
15,2020-02-03,00:00,15,0,0,0,15,475,490,490,3.06122449,2020-02-03 00:00:00.000,2021-10-07 10:30:51.51
14,2020-02-02,00:00,15,0,0,0,15,414,429,429,3.496503497,2020-02-02 00:00:00.000,2021-10-07 10:30:51.51
13,2020-02-01,00:00,12,0,0,0,12,359,371,371,3.234501348,2020-02-01 00:00:00.000,2021-10-07 10:30:51.51
12,2020-01-31,00:00,11,0,0,0,11,324,335,335,3.28358209,2020-01-31 00:00:00.000,2021-10-07 10:30:51.51
11,2020-01-30,00:00,7,0,0,0,7,268,275,275,2.545454545,2020-01-30 00:00:00.000,2021-10-07 10:30:51.51
10,2020-01-29,00:00,4,0,0,0,4,204,208,208,1.923076923,2020-01-29 00:00:00.000,2021-10-07 10:30:51.51
9,2020-01-28,00:00,4,0,0,0,4,133,137,137,2.919708029,2020-01-28 00:00:00.000,2021-10-07 10:30:51.51
8,2020-01-27,10:00,4,0,0,0,4,80,84,84,4.761904762,2020-01-27 10:00:00.000,2021-10-07 10:30:51.51
7,2020-01-26,09:00,3,0,0,0,3,53,56,56,5.357142857,2020-01-26 09:00:00.000,2021-10-07 10:30:51.51
6,2020-01-25,00:00,2,0,0,0,2,45,47,47,4.255319149,2020-01-25 00:00:00.000,2021-10-07 10:30:51.51
5,2020-01-24,00:00,2,0,0,0,2,27,29,29,6.896551724,2020-01-24 00:00:00.000,2021-10-07 10:30:51.51
4,2020-01-23,09:00,1,0,0,0,1,24,25,25,4,2020-01-23 09:00:00.000,2021-10-07 10:30:51.51
3,2020-01-22,12:00,1,0,0,0,1,20,21,21,4.761904762,2020-01-22 12:00:00.000,2021-10-07 10:30:51.51
2,2020-01-21,09:00,1,0,0,0,1,14,15,15,6.666666667,2020-01-21 09:00:00.000,2021-10-07 10:30:51.51
1,2020-01-20,17:00,1,0,0,0,1,3,4,4,25,2020-01-20 17:00:00.000,2021-10-07 10:30:51.51
